ï»¿Booking date,Value date,Voucher number,Text,Amount,Balance,Category
2025-03-07,2025-03-07,5490990789,46736344968,-179.0,3563.49,Other
2025-03-07,2025-03-07,5484798153,ICA LAPPKARR/25-03-06,-48.9,3742.49,Groceries
2025-03-07,2025-03-07,5490990789,393405707919,-176.0,3791.39,Other
2025-03-06,2025-03-06,5484019780,ICA LAPPKARR/25-03-05,-211.05,3967.39,Groceries
2025-03-05,2025-03-05,5484715227,WOLT        /25-03-04,-184.5,4178.44,Other
2025-03-04,2025-03-04,5484324728,REVOLUT  798/25-03-03,-120.0,4362.94,Other
2025-03-04,2025-03-04,5484292112,GRANDPA AB  /25-03-03,-850.0,4482.94,Other
2025-03-04,2025-03-04,5484248869,UNIQLO KINGS/25-03-03,-149.0,5332.94,Other
2025-03-04,2025-03-04,5484242941,7-ELEVEN 461/25-03-03,-34.0,5481.94,Other
2025-03-04,2025-03-04,5484536974,OOB SVEAVAGE/25-03-03,-70.0,5515.94,Other
2025-03-04,2025-03-04,5490990789,46730529560,-709.0,5585.94,Other
2025-03-03,2025-03-03,5484242780,LION BAR SVE/25-03-02,-99.0,6294.94,Other
2025-03-03,2025-03-03,5484242763,LION BAR SVE/25-03-01,-236.0,6393.94,Other
2025-03-03,2025-03-03,5484131701,WOLT        /25-03-02,-178.84,6629.94,Other
2025-03-03,2025-03-03,5484047591,UBR  PENDING/25-03-02,-92.0,6808.78,Other
2025-03-03,2025-03-03,5484029034,KNIVSODER AB/25-03-01,-166.0,6900.78,Other
2025-03-03,2025-03-03,5484028994,KNIVSODER AB/25-03-01,-146.0,7066.78,Other
2025-03-03,2025-03-03,5490990789,393405707919,-144.0,7212.78,Other
2025-03-03,2025-03-03,5490990789,393405707919,144.0,7356.78,Other
2025-03-03,2025-03-03,5490990789,393405707919,-144.0,7212.78,Other
2025-03-03,2025-03-02,5484774197,7-ELEVEN HOR/25-03-01,-51.0,7356.78,Other
2025-03-03,2025-03-02,5484479245,HALLON      /25-03-02,-109.0,7407.78,Other
2025-03-03,2025-03-02,5484302909,MORMOS DUMPL/25-03-01,-318.0,7516.78,Other
2025-03-03,2025-03-02,5490990789,46764364349,-30.0,7834.78,Other
2025-03-03,2025-03-01,5484608855,DE TECLA AB /25-02-28,-83.0,7864.78,Other
2025-03-03,2025-03-01,5484385931,WOLT        /25-02-28,-69.0,7947.78,Other
2025-03-03,2025-03-01,5484249003,WOLT        /25-02-28,-199.5,8016.78,Other
2025-03-03,2025-03-01,5484617188,LA NETA CITY/25-02-27,-130.0,8216.28,Other
2025-03-03,2025-03-01,5484336154,ICA LAPPKARR/25-02-28,-14.9,8346.28,Groceries
2025-03-03,2025-03-01,5484336139,ICA LAPPKARR/25-02-28,-48.9,8361.18,Groceries
2025-03-03,2025-03-01,5484807100,ODENLAB VIDA/25-02-28,-329.0,8410.08,Other
2025-02-28,2025-02-28,5490990789,46727798758,-20.0,8739.08,Other
2025-02-28,2025-02-28,5484030773,VETEKATTEN K/25-02-27,-92.0,8759.08,Other
2025-02-27,2025-02-27,5490990789,46761522279,-25.0,8851.08,Other
2025-02-27,2025-02-27,5484614993,WOLT        /25-02-26,-199.5,8876.08,Other
2025-02-27,2025-02-27,5490990789,46722450295,48.0,9075.58,Other
2025-02-27,2025-02-27,5490990733,ENKLA VARDAG,-50.0,9027.58,Other
2025-02-26,2025-02-26,5490990004,52673768661,-600.0,9077.58,Other
2025-02-26,2025-02-26,5490990004,52673768661,-4400.0,9677.58,Other
2025-02-26,2025-02-26,5484660591,TRANSFERWISE/25-02-25,-202.2,14077.58,Other
2025-02-26,2025-02-26,5484355145,ICA LAPPKARR/25-02-25,-48.9,14279.78,Groceries
2025-02-26,2025-02-26,5484355124,ICA LAPPKARR/25-02-25,-34.9,14328.68,Groceries
2025-02-26,2025-02-26,5056900011,STIFT  STOCKHOLMS STUDEN,-4381.0,14363.58,Other
2025-02-25,2025-02-25,5484815348,ICA LAPPKARR/25-02-24,-135.9,18744.58,Groceries
2025-02-24,2025-02-24,5484093481,WOLT        /25-02-23,-199.5,18880.48,Other
2025-02-24,2025-02-23,5484221202,PASADENA    /25-02-22,-256.07,19079.98,Other
2025-02-24,2025-02-22,5484471492,WOLT        /25-02-21,-250.74,19336.05,Other
2025-02-20,2025-02-20,5484316498,POWER SOURCE/25-02-19,-119.0,19586.79,Other
2025-02-20,2025-02-20,5484866654,ICA LAPPKARR/25-02-19,-57.23,19705.79,Groceries
2025-02-20,2025-02-20,5484866642,ICA LAPPKARR/25-02-19,-106.7,19763.02,Groceries
2025-02-20,2025-02-20,5490990789,46733251396,-4000.0,19869.72,Other
2025-02-20,2025-02-20,5841990687,H20525898662,21000.0,23869.72,Other
2025-02-18,2025-02-18,5484092917,AMSTERDAM   /25-02-17,-2242.38,2869.72,Other
2025-02-18,2025-02-18,5484773263,WOLT        /25-02-17,-260.74,5112.1,Other
2025-02-17,2025-02-17,5490990789,46733251397,-200.0,5372.84,Other
2025-02-17,2025-02-17,5490990789,46730529560,-310.0,5572.84,Other
2025-02-17,2025-02-17,5841990687,H17525709913,5800.0,5882.84,Other
2025-02-17,2025-02-16,5484808056,GOOGLE  YOUT/25-02-14,-95.0,82.84,Other
2025-02-17,2025-02-16,5484577549,TRANSFERWISE/25-02-15,-190.07,177.84,Other
2025-02-17,2025-02-16,5484858702,ICA LAPPKARR/25-02-15,-55.0,367.91,Groceries
2025-02-17,2025-02-16,5484858701,ICA LAPPKARR/25-02-15,-62.9,422.91,Groceries
2025-02-17,2025-02-15,5490990789,46733251397,200.0,485.81,Other
2025-02-17,2025-02-15,5484455761,SSP S A  - A/25-02-14,-149.13,285.81,Other
2025-02-10,2025-02-08,5484799051,ARLANDA EXPR/25-02-08,160.0,434.94,Other
2025-02-10,2025-02-08,5484687667,ZETTLE  ARLA/25-02-07,-340.0,274.94,Other
2025-02-10,2025-02-08,5484260097,WHSMITH T5B /25-02-07,-43.0,614.94,Other
2025-02-10,2025-02-08,5484724267,ICA LAPPKARR/25-02-07,-20.0,657.94,Groceries
2025-02-07,2025-02-07,5484019101,PRESSBYRAN 4/25-02-06,-51.0,677.94,Other
2025-02-07,2025-02-07,5484640075,GENTLEMEN S /25-02-06,-850.0,728.94,Other
2025-02-07,2025-02-07,5484227520,ICA LAPPKARR/25-02-06,-20.9,1578.94,Groceries
2025-02-07,2025-02-07,5484700164,LILLEBRORS B/25-02-06,-232.0,1599.84,Other
2025-02-07,2025-02-07,5484621850,ARLANDA EXPR/25-02-07,-160.0,1831.84,Other
2025-02-07,2025-02-07,5490990789,46730529560,400.0,1991.84,Other
2025-02-07,2025-02-07,5490990789,AB STORSTOCK,-43.0,1591.84,Other
2025-02-06,2025-02-06,5490990789,AB STORSTOCK,26.0,1634.84,Other
2025-02-06,2025-02-06,5490990789,AB STORSTOCK,26.0,1608.84,Other
2025-02-06,2025-02-06,5490990789,AB STORSTOCK,-26.0,1582.84,Other
2025-02-06,2025-02-06,5490990789,AB STORSTOCK,-26.0,1608.84,Other
2025-02-06,2025-02-06,9900000100,104008199280,413.64,1634.84,Other
2025-02-06,2025-02-06,5490990004,HARSHDEEPSIN,2.13,1221.2,Other
2025-02-04,2025-02-04,5484038819,PROFESSORN R/25-02-03,-155.0,1219.07,Other
2025-02-04,2025-02-04,5484652436,ICA LAPPKARR/25-02-03,-115.7,1374.07,Groceries
2025-02-03,2025-02-03,5034900010,STIFT  STOCKHOLMS STUDEN,-4381.0,1489.77,Other
2025-02-03,2025-02-02,5490990789,46733251396,4000.0,5870.77,Other
2025-02-03,2025-02-02,5484807322,HALLON      /25-02-02,-113.95,1870.77,Other
2025-02-03,2025-02-01,5484870784,WOLT        /25-01-31,-69.0,1984.72,Other
2025-02-03,2025-02-01,5484811517,WOLT        /25-01-31,-289.3,2053.72,Other
2025-01-31,2025-01-31,5484141295,ICA LAPPKARR/25-01-30,-48.9,2343.02,Groceries
2025-01-30,2025-01-30,5490990733,ENKLA VARDAG,-50.0,2391.92,Other
2025-01-27,2025-01-27,5484510145,ICA LAPPKARR/25-01-26,-118.6,2441.92,Groceries
2025-01-27,2025-01-25,5484538766,UBER     EAT/25-01-24,-278.0,2560.52,Transport
2025-01-27,2025-01-25,5490990789,46734808895,-25.0,2838.52,Other
2025-01-24,2025-01-24,5484530828,PRESSBYRAN 4/25-01-23,-51.0,2863.52,Other
2025-01-24,2025-01-24,5484371809,TOKYO RAMEN /25-01-23,-159.0,2914.52,Other
2025-01-24,2025-01-24,5484708240,ICA LAPPKARR/25-01-23,-41.9,3073.52,Groceries
2025-01-24,2025-01-24,5484301669,ODENLAB VIDA/25-01-23,-229.0,3115.42,Other
2025-01-23,2025-01-23,5484331138,SAN FRANCISC/25-01-22,-262.99,3344.42,Other
2025-01-23,2025-01-23,5490990789,46769760859,-20.0,3607.41,Other
2025-01-21,2025-01-21,5484051080,ICA LAPPKARR/25-01-20,-48.9,3627.41,Groceries
2025-01-20,2025-01-20,5484605111,ICA LAPPKARR/25-01-19,-27.8,3676.31,Groceries
2025-01-20,2025-01-20,5484262779,RABAT       /25-01-19,-906.54,3704.11,Other
2025-01-20,2025-01-18,5484586075,ICA LAPPKARR/25-01-17,-48.9,4610.65,Groceries
2025-01-17,2025-01-17,5484481509,PHOTOFUN    /25-01-16,-52.99,4659.55,Other
2025-01-17,2025-01-17,5484039911,NORMAL STOCK/25-01-16,-296.0,4712.54,Other
2025-01-16,2025-01-16,5484707361,PRESSBYRAN 4/25-01-16,-19.0,5008.54,Other
2025-01-16,2025-01-16,5490990789,AB STORSTOCK,-26.0,5027.54,Other
2025-01-15,2025-01-15,5484010947,GOOGLE  YOUT/25-01-14,-95.0,5053.54,Other
2025-01-15,2025-01-15,5484492694,ICA LAPPKARR/25-01-14,-39.8,5148.54,Groceries
2025-01-15,2025-01-15,5484492666,ICA LAPPKARR/25-01-14,-70.9,5188.34,Groceries
2025-01-14,2025-01-14,5484550012,ICA LAPPKARR/25-01-13,-119.5,5259.24,Groceries
2025-01-14,2025-01-14,5484549969,ICA LAPPKARR/25-01-13,-53.9,5378.74,Groceries
2025-01-13,2025-01-13,5490990789,46727634172,-30.0,5432.64,Other
2025-01-13,2025-01-12,5484386125,PRESSBYRAN 4/25-01-11,-26.0,5462.64,Other
2025-01-13,2025-01-12,5484611295,ICA LAPPKARR/25-01-11,-48.9,5488.64,Groceries
2025-01-13,2025-01-11,5484701005,GRAND STOCKH/25-01-10,-155.0,5537.54,Other
2025-01-13,2025-01-11,5484685820,PROFESSORN R/25-01-10,-45.0,5692.54,Other
2025-01-13,2025-01-11,5484685819,PROFESSORN R/25-01-10,-90.0,5737.54,Other
2025-01-13,2025-01-11,5490990789,46769701543,-20.0,5827.54,Other
2025-01-10,2025-01-10,5484047798,ICA LAPPKARR/25-01-09,-24.86,5847.54,Groceries
2025-01-10,2025-01-10,5484047779,ICA LAPPKARR/25-01-09,-129.13,5872.4,Groceries
2025-01-09,2025-01-09,5484404082,ICA LAPPKARR/25-01-08,-58.03,6001.53,Groceries
2025-01-09,2025-01-09,5484404046,ICA LAPPKARR/25-01-08,-133.4,6059.56,Groceries
2025-01-09,2025-01-09,5484287284,CLAS OHLSON /25-01-08,-119.9,6192.96,Other
2025-01-08,2025-01-08,5484100954,HIMALAYAN TH/25-01-07,-365.0,6312.86,Other
2025-01-08,2025-01-08,5490990789,46769517944,-20.0,6677.86,Other
2025-01-07,2025-01-07,5490990789,46734930020,-20.0,6697.86,Other
2025-01-07,2025-01-07,5484031572,ICA LAPPKARR/25-01-06,-48.9,6717.86,Groceries
2025-01-07,2025-01-07,5007900009,STIFT  STOCKHOLMS STUDEN,-4381.0,6766.76,Other
2025-01-07,2025-01-06,5490990789,46761522279,-20.0,11147.76,Other
2025-01-07,2025-01-06,5484791754,STORA COOP V/25-01-05,-29.9,11167.76,Groceries
2025-01-07,2025-01-06,5484686153,ICA LAPPKARR/25-01-05,-191.56,11197.66,Groceries
2025-01-07,2025-01-06,5490990789,AB STORSTOCK,-42.0,11389.22,Other
2025-01-07,2025-01-05,5484711453,MAX BURGERS /25-01-05,-131.0,11431.22,Restaurants
2025-01-07,2025-01-04,5490990789,46733251396,-1503.0,11562.22,Other
2025-01-07,2025-01-04,5490990789,46733251396,6500.0,13065.22,Other
2025-01-07,2025-01-04,5490990789,46733251396,6500.0,6565.22,Other
2025-01-02,2025-01-02,5484562870,HALLON      /25-01-02,-109.4,65.22,Other
2025-01-02,2025-01-02,5484215214,ICA LAPPKARR/25-01-01,-25.9,174.62,Groceries
2025-01-02,2025-01-01,5484840779,ICA LAPPKARR/24-12-31,-71.0,200.52,Groceries
2025-01-02,2025-01-01,5484840778,ICA LAPPKARR/24-12-31,-20.8,271.52,Groceries
2025-01-02,2025-01-01,5484840767,ICA LAPPKARR/24-12-31,-52.7,292.32,Groceries
2025-01-02,2025-01-01,5490990789,AB STORSTOCK,-26.0,345.02,Other
2025-01-02,2024-12-31,5490990789,AB STORSTOCK,-26.0,371.02,Other
2025-01-02,2024-12-31,5484357842,IKEA GAVLE I/24-12-30,-64.0,397.02,Shopping
2025-01-02,2024-12-31,5484243380,MCD UPPSALA /24-12-30,-90.0,461.02,Other
2025-01-02,2024-12-31,5484803949,ICA LAPPKARR/24-12-30,-37.8,551.02,Groceries
2024-12-30,2024-12-31,0000000000,RÃNTA,0.72,588.82,Other
2024-12-30,2024-12-29,5484223422,MAX BURGERS /24-12-28,-88.0,588.1,Restaurants
2024-12-30,2024-12-29,5484287544,ICA LAPPKARR/24-12-28,-23.9,676.1,Groceries
2024-12-30,2024-12-29,5484287525,ICA LAPPKARR/24-12-28,-28.5,700.0,Groceries
2024-12-30,2024-12-28,5490990789,46727795497,-25.0,728.5,Other
2024-12-30,2024-12-28,5490990789,46764422936,-146.0,753.5,Other
2024-12-30,2024-12-28,5484514754,DE TECLA AB /24-12-27,-96.0,899.5,Other
2024-12-30,2024-12-28,5484345001,REVOLUT  798/24-12-27,-120.0,995.5,Other
2024-12-30,2024-12-28,5484100397,ICA LAPPKARR/24-12-27,-102.7,1115.5,Groceries
2024-12-27,2024-12-27,5490990733,ENKLA VARDAG,-50.0,1218.2,Other
2024-12-27,2024-12-26,5484464397,ICA LAPPKARR/24-12-25,-221.4,1268.2,Groceries
2024-12-27,2024-12-26,5490990789,46733251396,1000.0,1489.6,Other
2024-12-23,2024-12-23,5484011088,SAN FRANCISC/24-12-22,-263.35,489.6,Other
2024-12-23,2024-12-23,5484053060,ICA LAPPKARR/24-12-22,-138.6,752.95,Groceries
2024-12-23,2024-12-23,5490990789,46734983392,-14.0,891.55,Other
2024-12-23,2024-12-22,5484149860,ICA LAPPKARR/24-12-21,-90.7,905.55,Groceries
2024-12-23,2024-12-21,5484474347,RYANAIR00000/24-12-19,-683.38,996.25,Other
2024-12-23,2024-12-21,5484474243,DUBLIN      /24-12-19,-356.99,1679.63,Other
2024-12-23,2024-12-21,5484344915,UNIQLO KINGS/24-12-20,-1098.0,2036.62,Other
2024-12-23,2024-12-21,5484514580,GENTLEMEN S /24-12-20,-850.0,3134.62,Other
2024-12-23,2024-12-21,5484377719,PROFESSORN R/24-12-20,-180.0,3984.62,Other
2024-12-23,2024-12-21,5484170075,OOB SVEAVAGE/24-12-20,-84.0,4164.62,Other
2024-12-20,2024-12-20,5490990789,46736344968,220.0,4248.62,Other
2024-12-20,2024-12-20,5490990789,46736344968,-220.0,4028.62,Other
2024-12-20,2024-12-20,5490990789,46769701543,-25.0,4248.62,Other
2024-12-19,2024-12-19,5484746743,ICA LAPPKARR/24-12-18,-79.68,4273.62,Groceries
2024-12-17,2024-12-17,5484370811,ALIEXPRESS C/24-12-16,-384.95,4353.3,Other
2024-12-16,2024-12-16,5484833789,ICA LAPPKARR/24-12-15,-55.8,4738.25,Groceries
2024-12-16,2024-12-15,5484554702,GOOGLE  YOUT/24-12-14,-95.0,4794.05,Other
2024-12-16,2024-12-15,5484052455,HIMALAYA LIV/24-12-13,-193.91,4889.05,Other
2024-12-16,2024-12-15,5490990789,46734788363,-205.0,5082.96,Other
2024-12-16,2024-12-15,5490990789,46769627063,-36.0,5287.96,Other
2024-12-16,2024-12-14,5490990789,46734922722,-30.0,5323.96,Other
2024-12-16,2024-12-14,5484156446,TRANSFERWISE/24-12-14,-202.2,5353.96,Other
2024-12-16,2024-12-14,5484188517,THE ENGLISH /24-12-13,-40.0,5556.16,Other
2024-12-16,2024-12-14,5484079880,ICA LAPPKARR/24-12-13,-47.5,5596.16,Groceries
2024-12-16,2024-12-14,5484079861,ICA LAPPKARR/24-12-13,-20.0,5643.66,Groceries
2024-12-13,2024-12-13,5484827601,WOLT        /24-12-12,-187.63,5663.66,Other
2024-12-13,2024-12-13,5484799551,ICA LAPPKARR/24-12-12,-57.8,5851.29,Groceries
2024-12-13,2024-12-13,5484799523,ICA LAPPKARR/24-12-12,-54.7,5909.09,Groceries
2024-12-12,2024-12-12,5484499744,ICA LAPPKARR/24-12-11,-113.8,5963.79,Groceries
2024-12-10,2024-12-10,5484451567,ICA LAPPKARR/24-12-09,-203.09,6077.59,Groceries
2024-12-09,2024-12-09,5484449797,CAFE SCHWEIZ/24-12-08,-124.0,6280.68,Other
2024-12-09,2024-12-07,5484022595,POWER SOURCE/24-12-06,-248.0,6404.68,Other
2024-12-09,2024-12-07,5484268085,ICA LAPPKARR/24-12-06,-59.7,6652.68,Groceries
2024-12-06,2024-12-06,5484878575,HIMALAYA LIV/24-12-04,-181.91,6712.38,Other
2024-12-05,2024-12-05,5484863829,REVOLUT  798/24-12-04,-120.0,6894.29,Other
2024-12-05,2024-12-05,5484491924,ICA LAPPKARR/24-12-04,-20.0,7014.29,Groceries
2024-12-04,2024-12-04,5484599513,POWER SOURCE/24-12-03,-119.0,7034.29,Other
2024-12-04,2024-12-04,5484246937,ICA LAPPKARR/24-12-03,-20.0,7153.29,Groceries
2024-12-04,2024-12-04,5490990789,46769771524,-25.0,7173.29,Other
2024-12-04,2024-12-04,5490990789,AB STORSTOCK,-42.0,7198.29,Other
2024-12-03,2024-12-03,5490990789,46761584268,-30.0,7240.29,Other
2024-12-02,2024-12-02,5490990789,46734922722,-20.0,7270.29,Other
2024-12-02,2024-12-02,5484351154,HALLON      /24-12-02,-110.5,7290.29,Other
2024-12-02,2024-12-02,5484451246,ICA LAPPKARR/24-12-01,-209.7,7400.79,Groceries
2024-12-02,2024-12-01,5484382931,BAPSANG AB  /24-11-30,-685.0,7610.49,Other
2024-12-02,2024-12-01,5484275958,ZETTLE  DROP/24-11-30,-42.0,8295.49,Other
2024-12-02,2024-12-01,5484236592,HIMALAYA LIV/24-11-29,-82.97,8337.49,Other
2024-12-02,2024-12-01,5484258356,HEMKOP STOCK/24-11-30,-110.85,8420.46,Other
2024-12-02,2024-11-30,5484626764,PRESSBYRAN 4/24-11-29,-26.0,8531.31,Other
2024-12-02,2024-11-30,5484428619,ICA LAPPKARR/24-11-29,-10.71,8557.31,Groceries
2024-12-02,2024-11-30,5490990789,46734983392,-30.0,8568.02,Other
2024-12-02,2024-11-30,5490990789,46736344968,437.5,8598.02,Other
2024-11-29,2024-11-29,5484826589,ICA LAPPKARR/24-11-28,-66.03,8160.52,Groceries
2024-11-29,2024-11-29,5490990789,46724445660,-30.0,8226.55,Other
2024-11-28,2024-11-28,5490990733,ENKLA VARDAG,-50.0,8256.55,Other
2024-11-27,2024-11-27,5484172399,ICA LAPPKARR/24-11-26,-211.6,8306.55,Groceries
2024-11-25,2024-11-25,5490990789,46733251397,3000.0,8518.15,Other
2024-11-25,2024-11-24,5484804135,MAX BURGERS /24-11-23,-49.0,5518.15,Restaurants
2024-11-25,2024-11-24,5484391669,FALLOUMI    /24-11-23,-105.0,5567.15,Other
2024-11-25,2024-11-23,5484523385,SAN FRANCISC/24-11-22,-266.17,5672.15,Other
2024-11-25,2024-11-23,5484132865,PROFESSORN R/24-11-22,-155.0,5938.32,Other
2024-11-25,2024-11-23,5484209262,DE TECLA AB /24-11-23,-123.0,6093.32,Other
2024-11-25,2024-11-23,5490990789,46734930020,-30.0,6216.32,Other
2024-11-22,2024-11-22,5484774746,ICA LAPPKARR/24-11-21,-132.51,6246.32,Groceries
2024-11-21,2024-11-21,5484784496,PROFESSORN R/24-11-20,-155.0,6378.83,Other
2024-11-20,2024-11-20,5484472189,ICA LAPPKARR/24-11-19,-20.0,6533.83,Groceries
2024-11-20,2024-11-20,5484472183,ICA LAPPKARR/24-11-19,-53.9,6553.83,Groceries
2024-11-19,2024-11-19,5484470594,SUBWAY ODENP/24-11-18,-153.0,6607.73,Other
2024-11-19,2024-11-19,5484838666,ICA LAPPKARR/24-11-18,-20.0,6760.73,Groceries
2024-11-19,2024-11-19,5490990789,46724445347,-15.0,6780.73,Other
2024-11-19,2024-11-19,5490990789,115 KULTURFÃ,-140.0,6795.73,Other
2024-11-19,2024-11-19,5490990163,AUT17:06,-100.0,6935.73,Other
2024-11-18,2024-11-18,5490990789,46734983392,-10.0,7035.73,Other
2024-11-18,2024-11-18,5484354617,PROFESSORN R/24-11-17,-134.0,7045.73,Other
2024-11-18,2024-11-18,5484135588,ICA LAPPKARR/24-11-17,-65.9,7179.73,Groceries
2024-11-18,2024-11-18,4323900008,STIFT  STOCKHOLMS STUDEN,-4381.0,7245.63,Other
2024-11-18,2024-11-17,5484262657,REVOLUT  798/24-11-16,-300.0,11626.63,Other
2024-11-18,2024-11-17,5484744639,WISE        /24-11-17,-202.2,11926.63,Other
2024-11-18,2024-11-17,5484652567,UBER     EAT/24-11-15,-235.5,12128.83,Transport
2024-11-18,2024-11-17,5484282448,ICA LAPPKARR/24-11-16,-12.0,12364.33,Groceries
2024-11-18,2024-11-16,5490990789,46733251397,8000.0,12376.33,Other
2024-11-15,2024-11-15,5484327939,GOOGLE  YOUT/24-11-14,-95.0,4376.33,Other
2024-11-15,2024-11-15,5484233416,7-ELEVEN DRO/24-11-14,-59.0,4471.33,Other
2024-11-15,2024-11-15,5484592268,LA NETA     /24-11-14,-287.0,4530.33,Other
2024-11-15,2024-11-15,5484534411,VETEKATTEN K/24-11-14,-48.0,4817.33,Other
2024-11-15,2024-11-15,5484366777,ICA LAPPKARR/24-11-14,-13.9,4865.33,Groceries
2024-11-14,2024-11-14,5490990789,46767488455,-20.0,4879.23,Other
2024-11-14,2024-11-14,5490990789,46724415386,34.0,4899.23,Other
2024-11-14,2024-11-14,5484402306,ICA LAPPKARR/24-11-13,-126.6,4865.23,Groceries
2024-11-14,2024-11-14,5490990789,46724415386,141.0,4991.83,Other
2024-11-13,2024-11-13,5484472525,ICA LAPPKARR/24-11-12,-33.9,4850.83,Groceries
2024-11-11,2024-11-11,5484769612,ICA LAPPKARR/24-11-10,-90.8,4884.73,Groceries
2024-11-11,2024-11-10,5484100264,PRESSBYRAN 4/24-11-09,-26.0,4975.53,Other
2024-11-11,2024-11-10,5484643515,INDIAN STREE/24-11-09,-304.0,5001.53,Other
2024-11-11,2024-11-10,5484852485,ICA LAPPKARR/24-11-09,-13.9,5305.53,Groceries
2024-11-11,2024-11-09,5490990789,46733251396,49.0,5319.43,Other
2024-11-11,2024-11-09,5490990789,MAX BURGERS,-98.0,5270.43,Restaurants
2024-11-11,2024-11-09,5484749475,WOLT        /24-11-08,-194.63,5368.43,Other
2024-11-11,2024-11-09,5490990789,TEKNISKA HÃG,-365.0,5563.06,Other
2024-11-11,2024-11-09,5490990789,INTRUM SVERI,-4572.49,5928.06,Other
2024-11-08,2024-11-08,5490990789,46733251397,10000.0,10500.55,Other
2024-11-08,2024-11-08,5484724327,ICA LAPPKARR/24-11-07,-20.0,500.55,Groceries
2024-11-07,2024-11-07,5484688814,ICA LAPPKARR/24-11-06,-116.71,520.55,Groceries
2024-11-06,2024-11-06,5484319729,ICA LAPPKARR/24-11-05,-23.8,637.26,Groceries
2024-11-04,2024-11-04,5484340435,ICA LAPPKARR/24-11-02,-196.3,661.06,Groceries
2024-11-04,2024-11-03,5490990789,46764364349,-25.0,857.36,Other
2024-11-04,2024-11-02,5484265056,HALLON      /24-11-02,-109.35,882.36,Other
2024-11-01,2024-11-01,5484874849,WOLT        /24-10-31,-192.93,991.71,Other
2024-10-31,2024-10-31,5484832991,ICA LAPPKARR/24-10-30,-75.7,1184.64,Groceries
2024-10-30,2024-10-30,5484416306,WOLT        /24-10-29,-199.75,1260.34,Other
2024-10-30,2024-10-30,5484549239,ICA LAPPKARR/24-10-29,-61.4,1460.09,Groceries
2024-10-30,2024-10-30,5490990733,ENKLA VARDAG,-50.0,1521.49,Other
2024-10-29,2024-10-29,5484598292,MAX BURGERS /24-10-28,-103.0,1571.49,Restaurants
2024-10-29,2024-10-29,5484566151,PRESSBYRAN 4/24-10-28,-52.0,1674.49,Other
2024-10-28,2024-10-28,5484568980,ICA LAPPKARR/24-10-27,-19.9,1726.49,Groceries
2024-10-28,2024-10-28,5484568978,ICA LAPPKARR/24-10-27,-144.7,1746.39,Groceries
2024-10-28,2024-10-27,5490990789,46769752949,-49.0,1891.09,Other
2024-10-28,2024-10-27,5490990789,46734996563,-25.0,1940.09,Other
2024-10-28,2024-10-27,5484446494,WOLT        /24-10-26,-218.03,1965.09,Other
2024-10-28,2024-10-27,5484674811,ICA LAPPKARR/24-10-26,-75.5,2183.12,Groceries
2024-10-28,2024-10-26,5484466405,ICA LAPPKARR/24-10-25,-13.9,2258.62,Groceries
2024-10-28,2024-10-26,5484466388,ICA LAPPKARR/24-10-25,-20.0,2272.52,Groceries
2024-10-25,2024-10-25,5490990789,46793255306,-45.75,2292.52,Other
2024-10-24,2024-10-24,5484045412,PRESSBYRAN 4/24-10-23,-26.0,2338.27,Other
2024-10-24,2024-10-24,5484129410,ICA LAPPKARR/24-10-23,-47.5,2364.27,Groceries
2024-10-23,2024-10-23,5490990789,491737066968,-25.0,2411.77,Other
2024-10-23,2024-10-23,5484256381,ICA LAPPKARR/24-10-22,-13.9,2436.77,Groceries
2024-10-23,2024-10-23,5484739463,SAN FRANCISC/24-10-22,-262.02,2450.67,Other
2024-10-22,2024-10-22,5484208495,PRESSBYRAN 4/24-10-21,-26.0,2712.69,Other
2024-10-21,2024-10-21,5490990789,46724445660,-19.0,2738.69,Other
2024-10-21,2024-10-20,5484747825,7-ELEVEN HOR/24-10-19,-50.0,2757.69,Other
2024-10-21,2024-10-20,5484557555,GENTLEMEN S /24-10-19,-850.0,2807.69,Other
2024-10-21,2024-10-20,5484531362,ICA LAPPKARR/24-10-19,-70.94,3657.69,Groceries
2024-10-21,2024-10-20,5484362687,ZETTLE  CAFE/24-10-19,-88.0,3728.63,Other
2024-10-21,2024-10-19,5484684837,WOLT        /24-10-18,-209.75,3816.63,Other
2024-10-21,2024-10-19,5484801030,ICA LAPPKARR/24-10-18,-28.0,4026.38,Groceries
2024-10-21,2024-10-19,5484801008,ICA LAPPKARR/24-10-18,-20.0,4054.38,Groceries
2024-10-21,2024-10-19,5490990789,46761522279,-30.0,4074.38,Other
2024-10-17,2024-10-17,5484444437,PRESSBYRAN 4/24-10-16,-50.0,4104.38,Other
2024-10-17,2024-10-17,5484442036,PRESSBYRAN 4/24-10-16,-66.0,4154.38,Other
2024-10-17,2024-10-17,5484594817,ICA LAPPKARR/24-10-16,-26.9,4220.38,Groceries
2024-10-16,2024-10-16,5490990163,AUT20:35 INS,500.0,4247.28,Other
2024-10-16,2024-10-16,5484056248,ICA LAPPKARR/24-10-15,-210.72,3747.28,Groceries
2024-10-16,2024-10-16,5490990789,AB STORSTOCK,-26.0,3958.0,Other
2024-10-16,2024-10-16,5490990789,AB STORSTOCK,-26.0,3984.0,Other
2024-10-15,2024-10-15,5484750172,REVOLUT  798/24-10-14,-120.0,4010.0,Other
2024-10-15,2024-10-15,5484552986,GOOGLE  YOUT/24-10-14,-69.0,4130.0,Other
2024-10-15,2024-10-15,5484521050,SUBWAY ODENP/24-10-14,-91.0,4199.0,Other
2024-10-14,2024-10-14,5484722854,INDIAN STREE/24-10-13,-468.0,4290.0,Other
2024-10-14,2024-10-13,5490990789,46769760859,-20.0,4758.0,Other
2024-10-14,2024-10-13,5490990789,46733251396,234.0,4778.0,Other
2024-10-14,2024-10-13,5484425243,WOLT        /24-10-13,-69.0,4544.0,Other
2024-10-14,2024-10-13,5484260607,WOLT        /24-10-12,-147.0,4613.0,Other
2024-10-14,2024-10-13,5484146801,GALLERIAN SH/24-10-12,-15.0,4760.0,Other
2024-10-14,2024-10-13,5484690621,NORMAL STOCK/24-10-12,-151.0,4775.0,Other
2024-10-14,2024-10-13,5484428782,IKEA GALLERI/24-10-12,-137.0,4926.0,Shopping
2024-10-14,2024-10-13,5484428409,IKEA GALLERI/24-10-12,-39.0,5063.0,Shopping
2024-10-14,2024-10-13,5484274403,ICA LAPPKARR/24-10-12,-47.5,5102.0,Groceries
2024-10-14,2024-10-12,5484581961,PRESSBYRAN 4/24-10-11,-26.0,5149.5,Other
2024-10-14,2024-10-12,5484435864,ICA LAPPKARR/24-10-11,-80.8,5175.5,Groceries
2024-10-14,2024-10-12,5484058555,MORMOS DUMPL/24-10-11,-139.0,5256.3,Other
2024-10-14,2024-10-12,5490990789,46764364349,-25.0,5395.3,Other
2024-10-14,2024-10-12,5490990789,46733251396,68.0,5420.3,Other
2024-10-11,2024-10-11,5490990789,46730529560,-26.0,5352.3,Other
2024-10-10,2024-10-10,5484392436,ICA LAPPKARR/24-10-09,-218.6,5378.3,Groceries
2024-10-09,2024-10-09,5484698919,ICA LAPPKARR/24-10-08,-47.5,5596.9,Groceries
2024-10-09,2024-10-09,4282900007,SKATTEVERKET ID-KORT,-400.0,5644.4,Other
2024-10-09,2024-10-09,4282900006,SEKTIONEN FÃR ENERGI OCH,-1000.0,6044.4,Other
2024-10-08,2024-10-08,5484476258,MOUSER ELECT/24-10-07,-1888.31,7044.4,Other
2024-10-08,2024-10-08,5484798053,ICA LAPPKARR/24-10-07,-87.7,8932.71,Groceries
2024-10-07,2024-10-07,5484269275,HIMALAYA LIV/24-10-05,-306.91,9020.41,Other
2024-10-07,2024-10-07,5484790372,VOI SE      /24-10-05,-51.6,9327.32,Other
2024-10-07,2024-10-06,5484595142,PLANTAGEN FR/24-10-05,-219.85,9378.92,Other
2024-10-07,2024-10-06,5484508645,HEMKOP STOCK/24-10-05,-297.55,9598.77,Other
2024-10-07,2024-10-05,5484219364,GODCORP AB  /24-10-04,-254.1,9896.32,Other
2024-10-07,2024-10-05,5484197794,7-ELEVEN SVE/24-10-04,-50.0,10150.42,Other
2024-10-07,2024-10-05,5484518866,HIRSCHENKELL/24-10-04,-184.0,10200.42,Other
2024-10-07,2024-10-05,5490990789,AB STORSTOCK,-26.0,10384.42,Other
2024-10-07,2024-10-05,5490990789,AB STORSTOCK,-26.0,10410.42,Other
2024-10-04,2024-10-04,5490990789,46730529560,92.0,10436.42,Other
2024-10-04,2024-10-04,5490990163,AUT21:35 INS,1000.0,10344.42,Other
2024-10-04,2024-10-04,5490990789,AB STORSTOCK,-26.0,9344.42,Other
2024-10-04,2024-10-04,5484429761,UBER     EAT/24-10-03,-330.8,9370.42,Transport
2024-10-04,2024-10-04,5490990789,AB STORSTOCK,-26.0,9701.22,Other
2024-10-03,2024-10-03,5484324229,VOI SE      /24-10-02,-46.0,9727.22,Other
2024-10-03,2024-10-03,5484411531,RUSTY RASCAL/24-10-02,-155.0,9773.22,Other
2024-10-02,2024-10-02,5484273341,HALLON      /24-10-02,-109.35,9928.22,Other
2024-10-02,2024-10-02,5484088482,ICA LAPPKARR/24-10-01,-19.85,10037.57,Groceries
2024-10-02,2024-10-02,5484088450,ICA LAPPKARR/24-10-01,-62.5,10057.42,Groceries
2024-10-01,2024-10-01,4274900005,STIFT  STOCKHOLMS STUDEN,-4381.0,10119.92,Other
2024-09-30,2024-09-30,5484150583,WOLT        /24-09-29,-162.75,14500.92,Other
2024-09-30,2024-09-30,5490990789,46733251396,7000.0,14663.67,Other
2024-09-30,2024-09-30,5490990789,46733251396,7000.0,7663.67,Other
2024-09-30,2024-09-28,5484372472,ICA LAPPKARR/24-09-27,-160.5,663.67,Groceries
2024-09-27,2024-09-27,5484702972,POWER SOURCE/24-09-26,-278.0,824.17,Other
2024-09-27,2024-09-27,5484780002,ICA LAPPKARR/24-09-26,-49.0,1102.17,Groceries
2024-09-27,2024-09-27,5484779978,ICA LAPPKARR/24-09-26,-47.5,1151.17,Groceries
2024-09-26,2024-09-26,5484730900,WISE        /24-09-25,-101.1,1198.67,Other
2024-09-26,2024-09-26,5490990004,HARSHDEEPSIN,1000.0,1299.77,Other
2024-09-25,2024-09-25,5484794495,ICA LAPPKARR/24-09-24,-22.9,299.77,Groceries
2024-09-24,2024-09-24,5484716504,POWER SOURCE/24-09-23,-119.0,322.67,Other
2024-09-24,2024-09-24,5484014228,BURGER KING /24-09-22,-91.0,441.67,Restaurants
2024-09-23,2024-09-23,5484106123,REVOLUT  798/24-09-22,-1086.0,532.67,Other
2024-09-23,2024-09-23,5484540446,APOTEK HJART/24-09-22,-60.0,1618.67,Medical
2024-09-23,2024-09-23,5484296388,ICA LAPPKARR/24-09-22,-47.5,1678.67,Groceries
2024-09-23,2024-09-23,5484823144,SAN FRANCISC/24-09-22,-261.2,1726.17,Other
2024-09-23,2024-09-22,5484847335,WOLT        /24-09-21,-362.25,1987.37,Other
2024-09-23,2024-09-22,5484844876,ICA LAPPKARR/24-09-21,-71.8,2349.62,Groceries
2024-09-23,2024-09-22,5490990789,TRADERA MARK,378.9,2421.42,Other
2024-09-23,2024-09-22,5490990789,AB STORSTOCK,-26.0,2042.52,Other
2024-09-23,2024-09-22,5490990789,46730529560,170.0,2068.52,Other
2024-09-23,2024-09-21,5484058609,ICA LAPPKARR/24-09-20,-137.7,1898.52,Groceries
2024-09-23,2024-09-21,5484058592,ICA LAPPKARR/24-09-20,-12.9,2036.22,Groceries
2024-09-23,2024-09-21,5490990789,46730529560,-99.0,2049.12,Other
2024-09-20,2024-09-20,5484610610,PROFESSORN R/24-09-19,-105.0,2148.12,Other
2024-09-20,2024-09-20,5484335759,ICA LAPPKARR/24-09-19,-28.0,2253.12,Groceries
2024-09-20,2024-09-20,5490990789,46761531651,950.0,2281.12,Other
2024-09-20,2024-09-20,4263900004,SKATTEVERKET ID-KORT,-400.0,1331.12,Other
2024-09-19,2024-09-19,5484800700,HIMALAYA LIV/24-09-17,-186.96,1731.12,Other
2024-09-19,2024-09-19,5484603029,VOI SE      /24-09-18,-36.8,1918.08,Other
2024-09-19,2024-09-19,5484602857,VOI SE      /24-09-18,-36.8,1954.88,Other
2024-09-19,2024-09-19,5484180107,COOP NÃRA KR/24-09-18,-65.85,1991.68,Groceries
2024-09-18,2024-09-18,5490990789,46769760859,-20.0,2057.53,Other
2024-09-18,2024-09-18,5484844496,TEKNISKA KIO/24-09-17,-50.0,2077.53,Other
2024-09-18,2024-09-18,5484654276,INDIAN STREE/24-09-17,-405.0,2127.53,Other
2024-09-17,2024-09-17,5490990789,46769760859,-20.0,2532.53,Other
2024-09-17,2024-09-17,5484707519,ZETTLE  A B /24-09-16,-77.0,2552.53,Other
2024-09-17,2024-09-17,5484592880,WOLT        /24-09-16,-163.3,2629.53,Other
2024-09-17,2024-09-17,5484153889,ICA LAPPKARR/24-09-16,-108.05,2792.83,Groceries
2024-09-17,2024-09-17,5490990789,46767488455,-20.0,2900.88,Other
2024-09-16,2024-09-16,5484102485,FALAFELKUNGE/24-09-15,-139.0,2920.88,Other
2024-09-16,2024-09-16,5484083040,LION BAR SVE/24-09-15,-360.0,3059.88,Other
2024-09-16,2024-09-16,5484716715,THE ENGLISH /24-09-15,-140.0,3419.88,Other
2024-09-16,2024-09-16,5484103398,VOI SE      /24-09-14,-50.0,3559.88,Other
2024-09-16,2024-09-16,5484099563,UBR  PENDING/24-09-15,-149.0,3609.88,Other
2024-09-16,2024-09-16,5484098829,UBR  PENDING/24-09-14,-88.0,3758.88,Other
2024-09-16,2024-09-16,5490990789,46764385913,-20.0,3846.88,Other
2024-09-16,2024-09-16,5490990789,46793255306,192.0,3866.88,Other
2024-09-16,2024-09-16,5490990789,46793255306,-93.0,3674.88,Other
2024-09-16,2024-09-15,5484563952,GOOGLE  YOUT/24-09-14,-69.0,3767.88,Other
2024-09-16,2024-09-15,5484607959,ICA LAPPKARR/24-09-14,-97.4,3836.88,Groceries
2024-09-16,2024-09-15,5490990789,46724440996,-25.0,3934.28,Other
2024-09-16,2024-09-15,5490990163,AUT17:05 INS,500.0,3959.28,Other
2024-09-16,2024-09-15,5490990163,AUT17:03 INS,500.0,3459.28,Other
2024-09-16,2024-09-14,5490990789,46736344968,-75.0,2959.28,Other
2024-09-16,2024-09-14,5484520682,DUBLIN      /24-09-13,-174.16,3034.28,Other
2024-09-16,2024-09-14,5484520681,DUBLIN      /24-09-13,-626.91,3208.44,Other
2024-09-16,2024-09-14,5484335830,WOLT        /24-09-13,-205.8,3835.35,Other
2024-09-13,2024-09-13,5484593523,ICA LAPPKARR/24-09-12,-48.9,4041.15,Groceries
2024-09-13,2024-09-13,5484593474,ICA LAPPKARR/24-09-12,-94.82,4090.05,Groceries
2024-09-13,2024-09-13,5490990789,115 KULTURFÃ,-10.0,4184.87,Other
2024-09-12,2024-09-12,4255900003,SKATTEVERKET ID-KORT,-400.0,4194.87,Other
2024-09-11,2024-09-11,5484804635,WOLT        /24-09-10,-190.44,4594.87,Other
2024-09-10,2024-09-10,5484709348,ICA LAPPKARR/24-09-09,-109.76,4785.31,Groceries
2024-09-09,2024-09-09,5484478117,UBR  PENDING/24-09-07,-109.0,4895.07,Other
2024-09-09,2024-09-08,5490990789,46761012797,-34.0,5004.07,Other
2024-09-09,2024-09-08,5490990789,46764552794,82.0,5038.07,Other
2024-09-09,2024-09-07,5484542072,HIMALAYA LIV/24-09-05,-186.95,4956.07,Other
2024-09-09,2024-09-07,5484183469,BARAS STALLE/24-09-06,-250.0,5143.02,Other
2024-09-09,2024-09-07,5490990789,46769555419,-34.0,5393.02,Other
2024-09-06,2024-09-06,5490990789,AB STORSTOCK,-26.0,5427.02,Other
2024-09-06,2024-09-06,5484809134,ICA LAPPKARR/24-09-05,-47.5,5453.02,Groceries
2024-09-06,2024-09-06,5484809129,ICA LAPPKARR/24-09-05,-12.9,5500.52,Groceries
2024-09-06,2024-09-06,5484659276,NORMAL STOCK/24-09-05,-46.0,5513.42,Other
2024-09-05,2024-09-05,5484045317,WOLT        /24-09-04,-190.44,5559.42,Other
2024-09-05,2024-09-05,4248900002,STIFT  STOCKHOLMS STUDEN,-4381.0,5749.86,Other
2024-09-04,2024-09-04,5490990004,52673768661,-1000.0,10130.86,Other
2024-09-04,2024-09-04,5490990789,46733251396,5500.0,11130.86,Other
2024-09-04,2024-09-04,5490990789,46733251396,5500.0,5630.86,Other
2024-09-02,2024-09-02,5484558138,HALLON      /24-09-01,-109.0,130.86,Other
2024-09-02,2024-09-01,5484321869,WOLT        /24-08-31,-185.35,239.86,Other
2024-09-02,2024-09-01,5484236587,SKAFFERIET  /24-08-31,-93.0,425.21,Other
2024-09-02,2024-09-01,5484014414,PROFESSORN R/24-08-31,-134.0,518.21,Other
2024-09-02,2024-09-01,5484592843,ICA LAPPKARR/24-08-31,-28.0,652.21,Groceries
2024-09-02,2024-09-01,5484592814,ICA LAPPKARR/24-08-31,-47.5,680.21,Groceries
2024-09-02,2024-09-01,5490990789,46730529560,-135.0,727.71,Other
2024-09-02,2024-09-01,5490990789,46730529560,135.0,862.71,Other
2024-09-02,2024-09-01,5490990789,46730529560,-135.0,727.71,Other
2024-09-02,2024-09-01,5490990789,46761012797,-72.0,862.71,Other
2024-09-02,2024-09-01,5490990789,46730529560,135.0,934.71,Other
2024-09-02,2024-09-01,5490990789,46730529560,-135.0,799.71,Other
2024-09-02,2024-09-01,5490990789,46730529560,135.0,934.71,Other
2024-09-02,2024-09-01,5490990789,46730529560,-135.0,799.71,Other
2024-09-02,2024-09-01,5490990789,46730529560,135.0,934.71,Other
2024-09-02,2024-09-01,5490990789,46730529560,-135.0,799.71,Other
2024-09-02,2024-09-01,5490990004,HARSHDEEPSIN,300.0,934.71,Other
2024-09-02,2024-09-01,5490990789,46769555419,20.0,634.71,Other
2024-09-02,2024-08-31,5490990004,HARSHDEEPSIN,200.0,614.71,Other
2024-09-02,2024-08-31,5484667519,GENERATOR HO/24-08-30,-72.0,414.71,Other
2024-09-02,2024-08-31,5484667508,GENERATOR HO/24-08-30,-96.0,486.71,Other
2024-09-02,2024-08-31,5484269534,WOLT        /24-08-31,-69.0,582.71,Other
2024-09-02,2024-08-31,5484150536,UBR  PENDING/24-08-30,-77.0,651.71,Other
2024-09-02,2024-08-31,5484446888,ICA LAPPKARR/24-08-30,-149.5,728.71,Groceries
2024-09-02,2024-08-31,5490990789,46764419562,-90.0,878.21,Other
2024-09-02,2024-08-31,5490990789,46736344968,50.0,968.21,Other
2024-09-02,2024-08-31,5490990789,46764364349,-30.0,918.21,Other
2024-09-02,2024-08-31,5490990004,HARSHDEEPSIN,500.0,948.21,Other
2024-09-02,2024-08-31,5490990789,46764552794,-95.0,448.21,Other
2024-08-29,2024-08-29,5484564977,PROFESSORN R/24-08-28,-178.0,543.21,Other
2024-08-29,2024-08-29,5484460627,ICA LAPPKARR/24-08-28,-68.7,721.21,Groceries
2024-08-28,2024-08-28,5490990004,HARSHDEEPSIN,414.0,789.91,Other
2024-08-28,2024-08-28,5490990004,52673768661,-207.0,375.91,Other
2024-08-28,2024-08-28,5484559839,GENTLEMEN S /24-08-27,-550.0,582.91,Other
2024-08-28,2024-08-28,5484042890,ICA LAPPKARR/24-08-27,-127.3,1132.91,Groceries
2024-08-27,2024-08-27,5484800124,MAX BURGERS /24-08-26,-158.0,1260.21,Restaurants
2024-08-27,2024-08-27,5484478778,KISTA GROSSE/24-08-26,-105.13,1418.21,Other
2024-08-27,2024-08-27,5490990789,AB STORSTOCK,-26.0,1523.34,Other
2024-08-27,2024-08-27,5490990789,AB STORSTOCK,-26.0,1549.34,Other
2024-08-26,2024-08-26,5490990789,AB STORSTOCK,-26.0,1575.34,Other
2024-08-26,2024-08-26,5490990789,AB STORSTOCK,-26.0,1601.34,Other
2024-08-26,2024-08-25,5484501264,ICA LAPPKARR/24-08-24,-93.49,1627.34,Groceries
2024-08-26,2024-08-24,5484699085,ICA LAPPKARR/24-08-23,-95.3,1720.83,Groceries
2024-08-23,2024-08-23,5484412732,SAN FRANCISC/24-08-22,-261.2,1816.13,Other
2024-08-23,2024-08-23,5484206260,PROFESSORN R/24-08-22,-134.0,2077.33,Other
2024-08-21,2024-08-21,5484720917,LIME RIDE KK/24-08-20,-88.0,2211.33,Other
2024-08-21,2024-08-21,5484722857,ICA LAPPKARR/24-08-20,-52.75,2299.33,Groceries
2024-08-21,2024-08-21,5490990789,46793431786,-25.0,2352.08,Other
2024-08-20,2024-08-20,5484285636,POWER SOURCE/24-08-19,-129.0,2377.08,Other
2024-08-20,2024-08-20,5484200780,ICA LAPPKARR/24-08-19,-47.5,2506.08,Groceries
2024-08-19,2024-08-18,5490990789,MAX BURGERS,-121.0,2553.58,Restaurants
2024-08-19,2024-08-18,5490990789,AB STORSTOCK,-26.0,2674.58,Other
2024-08-19,2024-08-18,5490990789,46733251397,250.0,2700.58,Other
2024-08-19,2024-08-18,5484010005,BOULEBAR SVE/24-08-17,-250.0,2450.58,Other
2024-08-19,2024-08-18,5484392175,HAPPY TIMES /24-08-17,-75.0,2700.58,Other
2024-08-19,2024-08-18,5490990789,491573255871,-200.0,2775.58,Other
2024-08-19,2024-08-18,5490990789,46730529560,200.0,2975.58,Other
2024-08-19,2024-08-18,5490990789,AB STORSTOCK,-26.0,2775.58,Other
2024-08-19,2024-08-18,5490990789,46733251396,-60.0,2801.58,Other
2024-08-19,2024-08-18,5490990789,AB STORSTOCK,-26.0,2861.58,Other
2024-08-19,2024-08-17,5490990789,46763447679,-25.0,2887.58,Other
2024-08-19,2024-08-17,5484602322,CHSD RESTAUR/24-08-16,-82.0,2912.58,Other
2024-08-19,2024-08-17,5490990789,46764478261,-30.0,2994.58,Other
2024-08-16,2024-08-16,5484739308,ICA LAPPKARR/24-08-15,-157.2,3024.58,Groceries
2024-08-16,2024-08-16,5490990789,46733251397,-150.0,3181.78,Other
2024-08-16,2024-08-16,5490990789,46733251397,150.0,3331.78,Other
2024-08-15,2024-08-15,5484563497,7-ELEVEN STH/24-08-14,-34.0,3181.78,Other
2024-08-15,2024-08-15,5484374110,MORMOS DUMPL/24-08-14,-303.0,3215.78,Other
2024-08-15,2024-08-14,5490990789,46763447679,-20.0,3518.78,Other
2024-08-14,2024-08-14,5484316904,HIMALAYA LIV/24-08-12,-98.95,3538.78,Other
2024-08-13,2024-08-13,5484669389,ICA LAPPKARR/24-08-12,-186.22,3637.73,Groceries
2024-08-13,2024-08-13,5484669365,ICA LAPPKARR/24-08-12,-15.0,3823.95,Groceries
2024-08-12,2024-08-12,5484342632,INDIAN STREE/24-08-11,-820.0,3838.95,Other
2024-08-12,2024-08-12,5490990789,46769761455,-25.0,4658.95,Other
2024-08-12,2024-08-11,5490990789,46764364349,-40.0,4683.95,Other
2024-08-12,2024-08-11,5484085098,SARAVANAA IN/24-08-10,-194.0,4723.95,Other
2024-08-12,2024-08-11,5490990789,46733251396,275.0,4917.95,Other
2024-08-12,2024-08-10,5490990789,46734930020,-20.0,4642.95,Other
2024-08-12,2024-08-10,5484061747,ICA LAPPKARR/24-08-09,-37.78,4662.95,Groceries
2024-08-09,2024-08-09,5484228601,PROFESSORN R/24-08-08,-119.0,4700.73,Other
2024-08-09,2024-08-09,5490990789,46735724636,-120.0,4819.73,Other
2024-08-09,2024-08-09,5490990004,52673768661,-1207.0,4939.73,Other
2024-08-09,2024-08-09,5490990789,INTRUM SVERI,-4573.93,6146.73,Other
2024-08-09,2024-08-09,5490990789,46730529560,-346.0,10720.66,Other
2024-08-09,2024-08-09,5490990789,46733251396,-3400.0,11066.66,Other
2024-08-09,2024-08-09,5490990789,46733251397,13800.0,14466.66,Other
2024-08-08,2024-08-08,5490990789,46734922722,-25.0,666.66,Other
2024-08-08,2024-08-08,5490990789,46724415386,-179.0,691.66,Other
2024-08-08,2024-08-08,5484367083,LIDL 257 STH/24-08-07,-309.87,870.66,Groceries
2024-08-08,2024-08-08,5484171045,HALLON      /24-08-08,-109.0,1180.53,Other
2024-08-07,2024-08-07,5484667154,ICA LAPPKARR/24-08-06,-27.9,1289.53,Groceries
2024-08-07,2024-08-07,5484133232,AQUA DENTAL /24-08-07,-1745.0,1317.43,Other
2024-08-07,2024-08-07,5490990789,46734922722,-25.0,3062.43,Other
2024-08-06,2024-08-06,5490990789,46733251396,2500.0,3087.43,Other
2024-08-06,2024-08-06,9900000100,SK9809179014,527.0,587.43,Other
2024-08-05,2024-08-05,5484219915,LA NETA     /24-08-03,-115.0,60.43,Other
2024-08-05,2024-08-05,5484025991,ICA LAPPKARR/24-08-04,-113.34,175.43,Groceries
2024-08-05,2024-08-04,5484097286,AT SIX      /24-08-03,-90.0,288.77,Other
2024-08-05,2024-08-04,5490990789,46727843763,-190.0,378.77,Other
2024-08-05,2024-08-03,5490990789,46769761455,-25.0,568.77,Other
2024-08-05,2024-08-03,5490990789,46736344968,45.0,593.77,Other
2024-08-05,2024-08-03,5490990789,46733251396,500.0,548.77,Other
2024-08-01,2024-08-01,5490990789,46769607848,-25.0,48.77,Other
2024-07-22,2024-07-20,5490990789,46793431786,-25.0,73.77,Other
2024-07-18,2024-07-18,5490990789,46764364349,-25.0,98.77,Other
2024-07-15,2024-07-13,5490990789,46724415386,30.0,123.77,Other
2024-07-15,2024-07-13,5490990789,46793431786,-25.0,93.77,Other
2024-07-15,2024-07-13,5490990789,46769627063,-127.0,118.77,Other
2024-07-12,2024-07-12,5490990789,46769555419,-28.0,245.77,Other
2024-07-12,2024-07-12,5490990789,46734788363,-150.0,273.77,Other
2024-07-12,2024-07-12,5490990789,393405707919,-88.0,423.77,Other
2024-07-12,2024-07-12,5490990789,46736344968,-1577.0,511.77,Other
2024-07-10,2024-07-10,5490990789,AB STORSTOCK,-26.0,2088.77,Other
2024-07-10,2024-07-10,5841990687,H10516104914,2000.0,2114.77,Other
2024-07-04,2024-07-04,5484302862,CHISINAU  MU/24-07-02,-33.49,114.77,Other
2024-07-04,2024-07-04,5490990789,393405707919,-133.0,148.26,Other
2024-07-04,2024-07-04,5490990789,46733251397,200.0,281.26,Other
2024-07-03,2024-07-03,5490990789,393405707919,18.0,81.26,Other
2024-07-02,2024-07-02,5484582876,VETEKATTEN K/24-06-29,-144.0,63.26,Other
2024-07-01,2024-07-01,5484121713,CHISINAU    /24-06-30,-30.5,207.26,Other
2024-07-01,2024-06-30,5484678736,ICA LAPPKARR/24-06-29,-207.68,237.76,Groceries
2024-07-01,2024-06-30,5484539071,FTC STHLM DR/24-06-29,-80.0,445.44,Other
2024-07-01,2024-06-29,5484206682,POWER SOURCE/24-06-27,-125.0,525.44,Other
2024-07-01,2024-06-29,5490990789,46761571433,-25.0,650.44,Other
2024-06-28,2024-06-28,5484090674,ICA LAPPKARR/24-06-27,-54.9,675.44,Groceries
2024-06-25,2024-06-25,5490990789,393405707919,618.0,730.34,Other
2024-06-24,2024-06-23,5490990789,46727774770,-30.0,112.34,Other
2024-06-24,2024-06-22,5490990789,46764393398,-20.0,142.34,Other
2024-06-24,2024-06-22,5490990789,AB STORSTOCK,-42.0,162.34,Other
2024-06-24,2024-06-22,5490990789,46733251396,200.0,204.34,Other
2024-06-20,2024-06-20,5490990789,46767488455,-25.0,4.34,Other
2024-06-20,2024-06-20,5490990789,46767488455,-25.0,29.34,Other
2024-06-19,2024-06-19,5490990789,46764552794,41.0,54.34,Other
2024-05-27,2024-05-26,5490990789,46761572904,-100.0,13.34,Other
2024-05-27,2024-05-26,5490990789,46736344968,-300.0,113.34,Other
2024-05-27,2024-05-25,5490990789,46764422936,319.0,413.34,Other
2024-05-27,2024-05-25,5490990789,AB STORSTOCK,-26.0,94.34,Other
2024-05-27,2024-05-25,5490990789,AB STORSTOCK,-26.0,120.34,Other
2024-05-23,2024-05-23,5490990789,46767474435,-20.0,146.34,Other
2024-05-22,2024-05-22,5484342355,7-ELEVEN 461/24-05-21,-62.0,166.34,Other
2024-05-22,2024-05-22,5484186006,ICA LAPPKARR/24-05-21,-61.8,228.34,Groceries
2024-05-22,2024-05-22,5490990789,AB STORSTOCK,-26.0,290.14,Other
2024-05-22,2024-05-22,5490990789,AB STORSTOCK,-26.0,316.14,Other
2024-05-21,2024-05-21,5490990789,46763447679,-20.0,342.14,Other
2024-05-21,2024-05-21,5484654922,PROFESSORN R/24-05-20,-134.0,362.14,Other
2024-05-21,2024-05-21,5490990789,46733251397,-314.0,496.14,Other
2024-05-20,2024-05-20,5484458432,7-ELEVEN 461/24-05-19,-34.0,810.14,Other
2024-05-20,2024-05-19,5490990789,46764518404,-25.0,844.14,Other
2024-05-20,2024-05-19,5484829704,ICA LAPPKARR/24-05-18,-49.8,869.14,Groceries
2024-05-20,2024-05-18,5490990789,AB STORSTOCK,-26.0,918.94,Other
2024-05-20,2024-05-18,5490990789,46702900186,521.0,944.94,Other
2024-05-20,2024-05-18,5490990789,46736344968,369.0,423.94,Other
2024-05-20,2024-05-18,5490990789,AB STORSTOCK,-26.0,54.94,Other
2024-05-17,2024-05-17,5490990789,46764315991,-30.0,80.94,Other
2024-05-17,2024-05-17,5484780411,UBER     EAT/24-05-15,-205.3,110.94,Transport
2024-05-15,2024-05-15,5484462587,HIMALAYA LIV/24-05-13,-245.93,316.24,Other
2024-05-15,2024-05-15,5484391575,LA NETA     /24-05-14,-115.0,562.17,Other
2024-05-15,2024-05-15,5484369014,VETEKATTEN K/24-05-14,-48.0,677.17,Other
2024-05-15,2024-05-15,5484312904,ICA LAPPKARR/24-05-14,-200.3,725.17,Groceries
2024-05-14,2024-05-14,5490990789,46763447679,-20.0,925.47,Other
2024-05-13,2024-05-13,5484489827,WOLT        /24-05-12,-123.75,945.47,Other
2024-05-13,2024-05-13,5484601095,UBER     EAT/24-05-11,-205.3,1069.22,Transport
2024-05-13,2024-05-13,5490990789,AB STORSTOCK,-26.0,1274.52,Other
2024-05-13,2024-05-12,5484851824,ICA LAPPKARR/24-05-11,-59.8,1300.52,Groceries
2024-05-13,2024-05-11,5490990789,46760268200,250.0,1360.32,Other
2024-05-13,2024-05-11,5490990789,46760268200,971.0,1110.32,Other
2024-05-10,2024-05-09,5490990789,46734870972,-25.0,139.32,Other
2024-05-10,2024-05-09,5484802340,VETEKATTEN K/24-05-08,-110.0,164.32,Other
2024-05-08,2024-05-08,5490990789,46764364349,-25.0,274.32,Other
2024-05-08,2024-05-08,5484264110,ICA LAPPKARR/24-05-07,-59.8,299.32,Groceries
2024-05-07,2024-05-07,5484865288,ICA LAPPKARR/24-05-06,-319.07,359.12,Groceries
2024-05-06,2024-05-05,5484802381,WOLT        /24-05-04,-123.75,678.19,Other
2024-05-06,2024-05-05,5484361251,ICA NARA HOR/24-05-04,-132.71,801.94,Groceries
2024-05-06,2024-05-05,5484350307,ICA LAPPKARR/24-05-04,-81.5,934.65,Groceries
2024-05-06,2024-05-05,5484328200,ICA KVANTUM /24-05-04,-85.85,1016.15,Groceries
2024-05-06,2024-05-04,5484148669,ICA LAPPKARR/24-05-03,-20.0,1102.0,Groceries
2024-05-06,2024-05-04,5484548718,7-ELEVEN HOR/24-05-04,-60.0,1122.0,Other
2024-05-06,2024-05-04,5490990789,AB STORSTOCK,-26.0,1182.0,Other
2024-05-06,2024-05-04,5490990789,AB STORSTOCK,-26.0,1208.0,Other
2024-05-03,2024-05-03,5484680490,WOLT        /24-05-02,-120.5,1234.0,Other
2024-05-03,2024-05-03,5484778271,ICA LAPPKARR/24-05-02,-74.9,1354.5,Groceries
2024-05-02,2024-05-02,5484401626,HIMALAYA LIV/24-04-30,-155.93,1429.4,Other
2024-05-02,2024-05-01,5484285554,WOLT        /24-04-30,-123.75,1585.33,Other
2024-04-29,2024-04-29,5484315770,WOLT        /24-04-28,-225.75,1709.08,Other
2024-04-29,2024-04-28,5484633225,ICA LAPPKARR/24-04-27,-13.9,1934.83,Groceries
2024-04-29,2024-04-28,5484633224,ICA LAPPKARR/24-04-27,-46.9,1948.73,Groceries
2024-04-29,2024-04-27,5484043013,WOLT        /24-04-26,-123.75,1995.63,Other
2024-04-26,2024-04-26,5484116020,ICA LAPPKARR/24-04-25,-104.7,2119.38,Groceries
2024-04-25,2024-04-25,5484613700,UBER     EAT/24-04-24,-478.0,2224.08,Transport
2024-04-24,2024-04-24,5490990789,46723982783,2625.0,2702.08,Other
2024-04-22,2024-04-20,5490990789,AB STORSTOCK,-26.0,77.08,Other
2024-04-19,2024-04-19,5490990789,46736344968,-69.0,103.08,Other
2024-04-19,2024-04-19,5490990789,46736344968,150.0,172.08,Other
2024-04-19,2024-04-19,5490990789,46736344968,-150.0,22.08,Other
2024-04-19,2024-04-19,5490990789,46736344968,150.0,172.08,Other
2024-04-12,2024-04-12,5490990789,393405707919,-111.0,22.08,Other
2024-04-12,2024-04-12,5490990789,AB STORSTOCK,-26.0,133.08,Other
2024-04-10,2024-04-10,5490990789,AB STORSTOCK,-26.0,159.08,Other
2024-03-25,2024-03-25,5490990789,46733251397,-225.0,185.08,Other
2024-03-25,2024-03-25,5490990789,46733251397,225.0,410.08,Other
2024-03-18,2024-03-16,5490990789,393405707919,180.0,185.08,Other
2024-03-04,2024-03-03,5490990789,46764504165,-25.0,5.08,Other
2024-03-04,2024-03-03,5490990789,AB STORSTOCK,-26.0,30.08,Other
2024-03-04,2024-03-02,5490990789,AB STORSTOCK,-26.0,56.08,Other
2024-03-04,2024-03-02,5490990789,AB STORSTOCK,-26.0,82.08,Other
2024-03-04,2024-03-02,5490990789,46767474435,-30.0,108.08,Other
2024-02-26,2024-02-25,5490990789,46764422936,-149.0,138.08,Other
2024-02-26,2024-02-25,5490990789,46767568002,-30.0,287.08,Other
2024-02-26,2024-02-25,5490990789,46736344968,30.0,317.08,Other
2024-02-22,2024-02-22,5490990789,46724415386,100.0,287.08,Other
2024-02-19,2024-02-17,5484060962,ICA LAPPKARR/24-02-16,-37.9,187.08,Groceries
2024-02-15,2024-02-15,5490990789,46724415386,125.0,224.98,Other
2024-02-15,2024-02-15,5490990789,AB STORSTOCK,-42.0,99.98,Other
2024-02-12,2024-02-10,5490990789,46734870972,-25.0,141.98,Other
2024-02-12,2024-02-10,5490990789,46769627063,-128.0,166.98,Other
2024-02-12,2024-02-10,5490990789,46733251396,252.0,294.98,Other
2024-02-08,2024-02-08,5490990789,AB STORSTOCK,-42.0,42.98,Other
2024-02-02,2024-02-02,5490990789,46764393398,-25.0,84.98,Other
2024-01-29,2024-01-28,5484397203,WOLT        /24-01-27,-243.0,109.98,Other
2024-01-29,2024-01-27,5490990789,46733251396,140.0,352.98,Other
2024-01-25,2024-01-25,5490990789,46733251397,100.0,212.98,Other
2024-01-23,2024-01-23,5490990789,46733251397,-100.0,112.98,Other
2024-01-19,2024-01-19,5490990789,46764360375,-200.0,212.98,Other
2024-01-19,2024-01-19,5490990789,46733251396,-200.0,412.98,Other
2024-01-19,2024-01-19,5490990004,HARSHDEEPSIN,1.42,612.98,Other
2024-01-19,2024-01-19,5490990789,46736344968,-351.0,611.56,Other
2024-01-19,2024-01-19,5841990687,KOSTNAD,-50.0,962.56,Other
2024-01-19,2024-01-19,5841990687,H19508253588,1000.0,1012.56,Other
2024-01-18,2024-01-18,5490990789,46734825026,-200.0,12.56,Other
2024-01-18,2024-01-18,5490990789,46733251386,200.0,212.56,Other
2024-01-17,2024-01-17,5490990789,46764454873,-20.0,12.56,Other
2024-01-08,2024-01-06,5484291137,ICA LAPPKARR/24-01-05,-15.0,32.56,Groceries
2024-01-02,2023-12-31,5484670197,BOLT EU/O/23/23-12-31,-162.0,47.56,Other
2023-12-29,2023-12-31,0000000000,RÃNTA,0.47,209.56,Other
2023-12-27,2023-12-26,5490990789,46736344968,90.0,209.09,Other
2023-12-27,2023-12-25,5484300497,BOLT EU/O/23/23-12-25,-143.0,119.09,Other
2023-12-27,2023-12-24,5484747259,ICA LAPPKARR/23-12-23,-20.0,262.09,Groceries
2023-12-22,2023-12-22,5484857457,ICA LAPPKARR/23-12-21,-49.9,282.09,Groceries
2023-12-22,2023-12-22,5484857450,ICA LAPPKARR/23-12-21,-49.8,331.99,Groceries
2023-12-11,2023-12-10,5484547896,TAKE RAMEN  /23-12-09,-316.0,381.79,Other
2023-12-11,2023-12-09,5490990789,46733251396,50.0,697.79,Other
2023-12-11,2023-12-09,5490990789,46727634172,-30.0,647.79,Other
2023-12-07,2023-12-07,5484203982,MAX BURGERS /23-12-06,-71.0,677.79,Restaurants
2023-12-06,2023-12-06,5484134128,ICA LAPPKARR/23-12-05,-20.9,748.79,Groceries
2023-12-06,2023-12-06,5490990789,46764494715,-30.0,769.69,Other
2023-12-05,2023-12-05,5490990789,AB STORSTOCK,-26.0,799.69,Other
2023-12-04,2023-12-04,5490990789,46727821079,-30.0,825.69,Other
2023-12-04,2023-12-04,5490990789,46730529560,-740.0,855.69,Other
2023-12-04,2023-12-02,5490990789,46761533454,-25.0,1595.69,Other
2023-12-01,2023-12-01,8166942317,REGION DALAR,1393.0,1620.69,Other
2023-11-29,2023-11-29,5484874144,4308164 PRES/23-11-29,-26.0,227.69,Other
2023-11-28,2023-11-28,5484330360,ICA LAPPKARR/23-11-27,-225.5,253.69,Groceries
2023-11-24,2023-11-24,5490990789,AB STORSTOCK,-26.0,479.19,Other
2023-11-23,2023-11-23,5490990789,46736344968,-200.0,505.19,Other
2023-11-22,2023-11-22,5490990789,46735644982,-400.0,705.19,Other
2023-11-22,2023-11-22,5841990687,KOSTNAD,-50.0,1105.19,Other
2023-11-22,2023-11-22,5841990687,H22505441515,1000.0,1155.19,Other
2023-11-21,2023-11-21,5490990789,46764341590,-95.0,155.19,Other
2023-11-20,2023-11-19,5490990789,46730529560,230.5,250.19,Other
2023-11-20,2023-11-18,5490990789,46764341590,-47.5,19.69,Other
2023-11-20,2023-11-18,5490990789,46764341590,47.5,67.19,Other
2023-11-01,2023-11-01,5490990789,REGION DALAR,-94.0,19.69,Other
2023-11-01,2023-11-01,5490990789,46730529560,94.0,113.69,Other
2023-11-01,2023-11-01,5490990789,REGION DALAR,-94.0,19.69,Other
2023-10-31,2023-10-31,5490990789,AB STORSTOCK,-26.0,113.69,Other
2023-10-30,2023-10-29,5490990789,46769767726,-20.0,139.69,Other
2023-10-30,2023-10-28,5490990789,46767403059,-500.0,159.69,Other
2023-10-30,2023-10-28,5490990789,46733251396,500.0,659.69,Other
2023-10-30,2023-10-28,5490990789,46727715758,-40.0,159.69,Other
2023-10-30,2023-10-28,5490990789,46767500684,-30.0,199.69,Other
2023-10-26,2023-10-26,5490990789,393405707919,225.0,229.69,Other
2023-10-19,2023-10-19,5490990789,46734846988,-30.0,4.69,Other
2023-10-19,2023-10-19,5490990789,46764354058,-15.0,34.69,Other
2023-10-19,2023-10-19,5490990789,46764354058,-50.0,49.69,Other
2023-10-18,2023-10-18,5490990789,46727634172,-30.0,99.69,Other
2023-10-16,2023-10-14,5490990789,46727821079,-30.0,129.69,Other
2023-10-11,2023-10-11,5490990789,46736344968,-200.0,159.69,Other
2023-10-10,2023-10-10,5490990789,46730529560,-222.0,359.69,Other
2023-10-09,2023-10-08,5490990789,46733251396,-300.0,581.69,Other
2023-10-09,2023-10-08,5490990789,46767403059,550.0,881.69,Other
2023-10-09,2023-10-08,5490990789,46733251396,300.0,331.69,Other
2023-10-09,2023-10-07,5490990789,46767403059,-550.0,31.69,Other
2023-10-09,2023-10-07,5490990789,46730529560,75.0,581.69,Other
2023-10-03,2023-10-03,5484785683,MR CAKE AB  /23-10-02,-115.0,506.69,Other
2023-10-02,2023-10-02,5490990789,46769547850,-30.0,621.69,Other
2023-10-02,2023-10-01,5484876714,IKEA GALLERI/23-09-30,-229.0,651.69,Shopping
2023-09-29,2023-09-29,5490990789,46769704034,-30.0,880.69,Other
2023-09-28,2023-09-28,5490990789,46727634172,-30.0,910.69,Other
2023-09-25,2023-09-25,5490990789,46769547850,-30.0,940.69,Other
2023-09-25,2023-09-25,5484340389,ICA LAPPKARR/23-09-24,-14.9,970.69,Groceries
2023-09-25,2023-09-25,5490990789,46733251396,351.0,985.59,Other
2023-09-25,2023-09-24,5490990789,AB STORSTOCK,-26.0,634.59,Other
2023-09-25,2023-09-24,5490990789,AB STORSTOCK,-26.0,660.59,Other
2023-09-19,2023-09-19,5490990789,46734788363,-346.0,686.59,Other
2023-09-18,2023-09-18,5484080294,ICA LAPPKARR/23-09-17,-12.9,1032.59,Groceries
2023-09-18,2023-09-18,5490990789,AB STORSTOCK,-26.0,1045.49,Other
2023-09-18,2023-09-17,5490990789,46736344968,800.0,1071.49,Other
2023-09-13,2023-09-13,5484234449,ICA LAPPKARR/23-09-12,-12.9,271.49,Groceries
2023-09-11,2023-09-09,5484365152,ICA LAPPKARR/23-09-08,-20.0,284.39,Groceries
2023-09-07,2023-09-07,5484431287,ICA LAPPKARR/23-09-06,-20.0,304.39,Groceries
2023-09-06,2023-09-06,5484405349,ICA LAPPKARR/23-09-05,-33.9,324.39,Groceries
2023-09-06,2023-09-06,5484405317,ICA LAPPKARR/23-09-05,-29.9,358.29,Groceries
2023-09-05,2023-09-05,5490990004,2942576961 S,300.0,388.19,Other
2023-09-04,2023-09-04,5484820120,ICA LAPPKARR/23-09-03,-22.9,88.19,Groceries
2023-09-04,2023-09-02,5484219812,BLOMSTERLAND/23-09-01,-59.9,111.09,Other
2023-08-30,2023-08-30,5484578562,ICA LAPPKARR/23-08-29,-12.9,170.99,Groceries
2023-08-30,2023-08-30,5490990789,46733251397,-250.0,183.89,Other
2023-08-30,2023-08-30,5490990004,HARSHDEEPSIN,150.0,433.89,Other
2023-08-29,2023-08-29,5490990789,46736344968,-135.0,283.89,Other
2023-08-28,2023-08-28,5490990789,46734825029,-30.0,418.89,Other
2023-08-28,2023-08-27,5490990789,46733251396,100.0,448.89,Other
2023-08-28,2023-08-26,5490990789,46733251397,270.0,348.89,Other
2023-08-28,2023-08-26,5490990789,46733251396,-226.0,78.89,Other
2023-08-25,2023-08-25,3236900001,PLENO AB,-680.0,304.89,Other
2023-08-24,2023-08-24,5872990008,2604217776 S,305.56,984.89,Other
2023-08-23,2023-08-23,5484434345,ICA LAPPKARR/23-08-22,-12.9,679.33,Groceries
2023-08-23,2023-08-23,5484836242,IKEA GALLERI/23-08-22,-49.0,692.23,Shopping
2023-08-23,2023-08-23,9900000100,102893539098,500.0,741.23,Other
2023-08-21,2023-08-21,5484542016,MAX BURGERS /23-08-20,-89.0,241.23,Restaurants
2023-08-21,2023-08-20,5484878240,COOP VÃSTRA /23-08-19,-93.4,330.23,Groceries
2023-08-21,2023-08-19,5484310424,SYSTEMBOLAGE/23-08-18,-414.5,423.63,Other
2023-08-21,2023-08-19,5490990789,46727642259,-40.0,838.13,Other
2023-08-18,2023-08-18,5484456388,SUBWAY      /23-08-17,-102.0,878.13,Other
2023-08-18,2023-08-18,5484163769,ICA LAPPKARR/23-08-17,-13.9,980.13,Groceries
2023-08-18,2023-08-18,5484163736,ICA LAPPKARR/23-08-17,-20.0,994.03,Groceries
2023-08-18,2023-08-18,5490990004,HARSHDEEPSIN,500.0,1014.03,Other
2023-08-17,2023-08-17,5484365764,ZETTLE  STIK/23-08-16,-49.0,514.03,Other
2023-08-17,2023-08-17,5490990789,46735772221,40.0,563.03,Other
2023-08-17,2023-08-17,5490990789,AB STORSTOCK,-26.0,523.03,Other
2023-08-17,2023-08-17,5490990789,46736344968,142.0,549.03,Other
2023-08-16,2023-08-16,5490990789,46734848912,-25.0,407.03,Other
2023-08-16,2023-08-16,5490990789,46764341590,-113.0,432.03,Other
2023-08-16,2023-08-16,5484417987,ZETTLE  TAST/23-08-15,-88.0,545.03,Other
2023-08-16,2023-08-16,5484292085,IKEA GALLERI/23-08-15,-128.0,633.03,Shopping
2023-08-16,2023-08-16,5490990004,HARSHDEEPSIN,500.0,761.03,Other
2023-08-16,2023-08-16,5490990789,46767528191,-30.0,261.03,Other
2023-08-15,2023-08-15,5490990789,46763092377,40.0,291.03,Other
2023-08-15,2023-08-15,5490990004,HARSHDEEPSIN,200.0,251.03,Other
2023-08-14,2023-08-14,5484587630,LA NETA     /23-08-12,-46.0,51.03,Other
2023-08-14,2023-08-14,5484587627,LA NETA     /23-08-12,-165.0,97.03,Other
2023-08-14,2023-08-13,5484538221,ICA LAPPKARR/23-08-12,-33.8,262.03,Groceries
2023-08-14,2023-08-13,5490990789,46767528191,-25.0,295.83,Other
2023-08-14,2023-08-12,5490990789,46736344968,100.0,320.83,Other
2023-08-14,2023-08-12,5484688896,PROFESSORN R/23-08-11,-135.0,220.83,Other
2023-08-11,2023-08-11,5484680845,ICA LAPPKARR/23-08-10,-63.8,355.83,Groceries
2023-08-10,2023-08-10,5484019244,HIMALAYA LIV/23-08-08,-133.97,419.63,Other
2023-08-07,2023-08-06,5484262945,AT SIX      /23-08-05,-78.08,553.6,Other
2023-08-07,2023-08-06,5490990789,46734866329,40.0,631.68,Other
2023-08-07,2023-08-06,5490990789,46727600961,-45.0,591.68,Other
2023-08-07,2023-08-05,5490990789,46736344968,-22.5,636.68,Other
2023-08-07,2023-08-05,5490990789,46736344968,35.0,659.18,Other
2023-08-07,2023-08-05,5490990789,46736344968,-35.0,624.18,Other
2023-08-07,2023-08-05,5484511272,ODENPLAN SPE/23-08-04,-48.0,659.18,Other
2023-08-04,2023-08-04,5484212988,MAX BURGERS /23-08-03,-87.0,707.18,Restaurants
2023-08-04,2023-08-04,5484615884,LIDL 257 / S/23-08-03,-91.9,794.18,Groceries
2023-08-04,2023-08-04,5490990789,46736344968,-100.0,886.08,Other
2023-08-04,2023-08-04,5490990789,46761510662,200.0,986.08,Other
2023-08-03,2023-08-03,5490990789,46736344968,-230.0,786.08,Other
2023-08-03,2023-08-03,5490990789,46734788363,115.0,1016.08,Other
2023-08-03,2023-08-03,5490990789,46734771295,-60.0,901.08,Other
2023-08-02,2023-08-02,5490990789,46736344968,-70.0,961.08,Other
2023-08-02,2023-08-02,5490990789,46736344968,-100.0,1031.08,Other
2023-08-02,2023-08-02,5490990789,46733187714,200.0,1131.08,Other
2023-08-01,2023-08-01,5490990789,46729338118,40.0,931.08,Other
2023-08-01,2023-08-01,5490990789,46736344968,500.0,891.08,Other
2023-08-01,2023-08-01,5490990789,AB STORSTOCK,-26.0,391.08,Other
2023-08-01,2023-08-01,5490990789,AB STORSTOCK,-26.0,417.08,Other
2023-07-31,2023-07-31,5484572337,CALCUTTA FOO/23-07-30,-210.6,443.08,Other
2023-07-31,2023-07-30,5484386615,ICA LAPPKARR/23-07-29,-20.0,653.68,Groceries
2023-07-31,2023-07-29,5490990789,46761531651,-30.0,673.68,Other
2023-07-31,2023-07-29,5490990789,46767403059,-33.0,703.68,Other
2023-07-28,2023-07-28,5490990789,46704029196,-240.0,736.68,Other
2023-07-27,2023-07-27,5490990789,46734934094,-70.0,976.68,Other
2023-07-27,2023-07-26,5490990789,46730529560,239.0,1046.68,Other
2023-07-26,2023-07-26,5490990789,46733251396,-150.0,807.68,Other
2023-07-26,2023-07-26,5490990789,46736344968,239.0,957.68,Other
2023-07-26,2023-07-26,5490990004,HARSHDEEPSIN,500.0,718.68,Other
2023-07-26,2023-07-26,5490990004,52673768661,-500.0,218.68,Other
2023-07-25,2023-07-25,5490990789,46760858773,478.0,718.68,Other
2023-07-25,2023-07-25,5490990789,46764341590,-150.0,240.68,Other
2023-07-24,2023-07-24,5490990789,46704029196,240.0,390.68,Other
2023-07-24,2023-07-24,5484707154,ICA LAPPKARR/23-07-23,-20.0,150.68,Groceries
2023-07-24,2023-07-23,5484724098,THE LOCAL BA/23-07-21,-470.0,170.68,Other
2023-07-24,2023-07-23,5490990789,46769600091,-30.0,640.68,Other
2023-07-24,2023-07-23,5490990789,46733251396,150.0,670.68,Other
2023-07-24,2023-07-23,5490990789,46769752904,-350.0,520.68,Other
2023-07-24,2023-07-23,5490990789,46764341590,150.0,870.68,Other
2023-07-24,2023-07-23,5490990789,AB STORSTOCK,-26.0,720.68,Other
2023-07-24,2023-07-22,5484393689,NORMAL STOCK/23-07-21,-277.0,746.68,Other
2023-07-24,2023-07-22,5490990789,AB STORSTOCK,-26.0,1023.68,Other
2023-07-21,2023-07-21,5484854581,ICA LAPPKARR/23-07-20,-113.36,1049.68,Groceries
2023-07-21,2023-07-21,5484854566,ICA LAPPKARR/23-07-20,-102.7,1163.04,Groceries
2023-07-21,2023-07-21,5490990789,46727853265,-30.0,1265.74,Other
2023-07-18,2023-07-18,5484172488,INDIAN STREE/23-07-17,-195.0,1295.74,Other
2023-07-18,2023-07-18,5484519252,ICA LAPPKARR/23-07-17,-85.8,1490.74,Groceries
2023-07-18,2023-07-18,5484519226,ICA LAPPKARR/23-07-17,-33.9,1576.54,Groceries
2023-07-18,2023-07-18,5490990789,46769555419,-143.0,1610.44,Other
2023-07-17,2023-07-17,5490990789,46769600091,-30.0,1753.44,Other
2023-07-17,2023-07-16,5484392908,KONDITORI LY/23-07-15,-36.0,1783.44,Other
2023-07-17,2023-07-16,5484077769,HEMKOP BREDA/23-07-15,-21.5,1819.44,Other
2023-07-17,2023-07-16,5490990789,46760858773,-195.0,1840.94,Other
2023-07-17,2023-07-15,5484091161,4450159 PRES/23-07-14,-26.0,2035.94,Other
2023-07-17,2023-07-15,5484267392,HEMKOP BREDA/23-07-14,-75.85,2061.94,Other
2023-07-17,2023-07-15,5484044035,NORMAL STOCK/23-07-14,-78.0,2137.79,Other
2023-07-17,2023-07-15,5484506406,CAFE ALMEN  /23-07-14,-50.0,2215.79,Other
2023-07-17,2023-07-15,5490990789,AB STORSTOCK,-26.0,2265.79,Other
2023-07-14,2023-07-14,5490990789,AB STORSTOCK,-26.0,2291.79,Other
2023-07-14,2023-07-14,5490990789,AB STORSTOCK,-26.0,2317.79,Other
2023-07-13,2023-07-13,5484060805,BURGER KING /23-07-11,-55.0,2343.79,Restaurants
2023-07-11,2023-07-11,5484602164,ICA LAPPKARR/23-07-10,-81.8,2398.79,Groceries
2023-07-11,2023-07-11,5490990789,1234628913,-87.0,2480.59,Other
2023-07-10,2023-07-09,5484877352,STORA T KOLG/23-07-08,-135.0,2567.59,Other
2023-07-10,2023-07-09,5484877348,STORA T KOLG/23-07-08,-10.0,2702.59,Other
2023-07-10,2023-07-09,5484099926,ICA LAPPKARR/23-07-08,-67.9,2712.59,Groceries
2023-07-10,2023-07-08,5484144888,SYSTEMBOLAGE/23-07-07,-67.8,2780.49,Other
2023-07-10,2023-07-08,5490990789,46734788363,-82.0,2848.29,Other
2023-07-07,2023-07-07,5484856615,ICA LAPPKARR/23-07-06,-94.6,2930.29,Groceries
2023-07-05,2023-07-05,5484303403,SQ KIOSK    /23-07-04,-20.0,3024.89,Other
2023-07-05,2023-07-05,5484053957,LIDL 350 /SO/23-07-04,-69.8,3044.89,Groceries
2023-07-04,2023-07-04,5490990789,A-TRAIN AKTI,-160.0,3114.69,Other
2023-07-03,2023-07-03,5484128513,TOKYO RAMEN /23-07-02,-164.0,3274.69,Other
2023-07-03,2023-07-03,5484849905,CAFE SCHWEIZ/23-07-02,-104.0,3438.69,Other
2023-07-03,2023-07-03,5484631939,ICA LAPPKARR/23-07-02,-46.9,3542.69,Groceries
2023-07-03,2023-07-02,5490990789,46730529560,52.0,3589.59,Other
2023-07-03,2023-07-01,5490990789,46730529560,-103.0,3537.59,Other
2023-06-30,2023-06-30,5484088467,INDIAN STREE/23-06-28,-210.0,3640.59,Other
2023-06-28,2023-06-28,5490990789,46736344968,-33.0,3850.59,Other
2023-06-27,2023-06-27,5490990789,46730529560,457.0,3883.59,Other
2023-06-26,2023-06-26,5490990789,46736344968,277.0,3426.59,Other
2023-06-26,2023-06-26,5490990789,46769627063,-107.0,3149.59,Other
2023-06-26,2023-06-26,3781981004,LÃN,3000.0,3256.59,Other
2023-06-26,2023-06-25,5490990789,46765680441,-50.0,256.59,Other
2023-06-26,2023-06-24,5490990789,46736344968,183.0,306.59,Other
2023-06-22,2023-06-22,5490990789,46769555419,84.0,123.59,Other
2023-06-14,2023-06-14,5490990789,46723865611,25.0,39.59,Other
2023-06-05,2023-06-03,5490990789,AB STORSTOCK,-26.0,14.59,Other
2023-06-05,2023-06-03,5490990789,46769771029,-40.0,40.59,Other
2023-06-01,2023-06-01,5490990789,46764328924,-30.0,80.59,Other
2023-05-29,2023-05-28,5490990789,AB STORSTOCK,-26.0,110.59,Other
2023-05-26,2023-05-26,5490990789,46736344968,-321.0,136.59,Other
2023-05-26,2023-05-26,5490990789,46733251397,400.0,457.59,Other
2023-05-17,2023-05-17,5490990789,46736344968,-277.0,57.59,Other
2023-05-17,2023-05-17,5490990789,46767403059,132.0,334.59,Other
2023-05-15,2023-05-14,5490990789,46702188998,-40.0,202.59,Other
2023-05-12,2023-05-12,5484059097,THE LOCAL BA/23-05-11,-490.0,242.59,Other
2023-05-11,2023-05-11,5490990789,46767403059,-550.0,732.59,Other
2023-05-10,2023-05-10,5490990789,46734764640,900.0,1282.59,Other
2023-05-09,2023-05-09,5484560333,AVNI AB     /23-05-07,-130.0,382.59,Other
2023-05-09,2023-05-09,5484285231,ICA LAPPKARR/23-05-08,-20.0,512.59,Groceries
2023-05-08,2023-05-08,5484824223,ICA LAPPKARR/23-05-07,-34.9,532.59,Groceries
2023-05-08,2023-05-07,5484778449,BURGER KING /23-05-05,-105.0,567.49,Restaurants
2023-05-08,2023-05-07,5484507701,ICA LAPPKARR/23-05-06,-61.0,672.49,Groceries
2023-05-08,2023-05-07,5490990789,46736344968,-110.0,733.49,Other
2023-05-08,2023-05-06,5484190155,SYSTEMBOLAGE/23-05-05,-48.2,843.49,Other
2023-05-08,2023-05-06,5484113378,4308164 PRES/23-05-05,-30.0,891.69,Other
2023-05-08,2023-05-06,5490990789,46736344968,-145.0,921.69,Other
2023-05-05,2023-05-05,5490990789,1231351014,-20.0,1066.69,Other
2023-05-04,2023-05-04,5490990789,46736344968,412.0,1086.69,Other
2023-05-03,2023-05-03,5484299490,STAMPEN     /23-05-02,-215.0,674.69,Other
2023-05-02,2023-05-02,5490990789,46736344968,77.0,889.69,Other
2023-05-02,2023-04-30,5484297241,PROFESSORN R/23-04-29,-170.0,812.69,Other
2023-05-02,2023-04-30,5484863713,ICA LAPPKARR/23-04-29,-66.0,982.69,Groceries
2023-04-27,2023-04-27,5490990789,46733251396,-800.0,1048.69,Other
2023-04-27,2023-04-27,5490990789,46764341590,-76.0,1848.69,Other
2023-04-27,2023-04-27,5490990789,46734875557,-100.0,1924.69,Other
2023-04-27,2023-04-27,5841990687,H27492559982,2000.0,2024.69,Other
2023-04-19,2023-04-19,5490990789,46727642259,-30.0,24.69,Other
2023-04-17,2023-04-17,5490990789,46761533454,-30.0,54.69,Other
2023-04-17,2023-04-16,5490990789,46761589180,-30.0,84.69,Other
2023-04-17,2023-04-16,5484422246,ICA LAPPKARR/23-04-14,-40.9,114.69,Groceries
2023-04-17,2023-04-15,5484474083,PROFESSORN R/23-04-14,-123.0,155.59,Other
2023-04-17,2023-04-15,5484018895,HIMALAYA LIV/23-04-13,-88.96,278.59,Other
2023-04-17,2023-04-15,5490990789,46700019586,-900.0,367.55,Other
2023-04-14,2023-04-14,5490990789,46733251396,800.0,1267.55,Other
2023-04-14,2023-04-14,5490990789,46736344968,45.0,467.55,Other
2023-04-14,2023-04-14,5490990789,46735505571,-150.0,422.55,Other
2023-04-13,2023-04-13,5490990789,46764364349,-30.0,572.55,Other
2023-04-13,2023-04-13,5490990789,46733251396,-260.0,602.55,Other
2023-04-12,2023-04-12,5490990789,AB STORSTOCK,-26.0,862.55,Other
2023-04-11,2023-04-08,5490990789,46736344968,-95.0,888.55,Other
2023-04-11,2023-04-07,5490990789,46736344968,384.0,983.55,Other
2023-04-11,2023-04-07,5490990789,46764360375,220.0,599.55,Other
2023-04-11,2023-04-07,5490990789,491609755087,36.0,379.55,Other
2023-04-11,2023-04-07,5490990789,491609755087,328.0,343.55,Other
2023-03-20,2023-03-18,5490990789,46736344968,-64.0,15.55,Other
2023-03-20,2023-03-18,5490990789,46760858773,-197.0,79.55,Other
2023-03-20,2023-03-18,5490990789,46733251396,260.0,276.55,Other
2023-03-01,2023-03-01,5484599104,ICA LAPPKARR/23-02-28,-20.0,16.55,Groceries
2023-03-01,2023-03-01,5484052509,POWER SOURCE/23-02-28,-125.0,36.55,Other
2023-02-28,2023-02-28,5484304484,CLAS OHLSON /23-02-27,-39.9,161.55,Other
2023-02-28,2023-02-28,5490990789,46769600091,-30.0,201.45,Other
2023-02-27,2023-02-27,5490990789,AB STORSTOCK,-26.0,231.45,Other
2023-02-27,2023-02-27,5490990789,46733251397,-250.0,257.45,Other
2023-02-27,2023-02-27,5841990687,H27488924825,500.0,507.45,Other
2023-02-27,2023-02-27,5490990789,46733251397,-250.0,7.45,Other
2023-02-27,2023-02-26,5490990789,46739127037,150.0,257.45,Other
2023-02-27,2023-02-25,5490990789,46761531651,-30.0,107.45,Other
2023-02-20,2023-02-19,5490990789,46733251396,13.0,137.45,Other
2023-02-16,2023-02-16,5490990789,AB STORSTOCK,-26.0,124.45,Other
2023-02-16,2023-02-16,5490990789,46733251396,-30.0,150.45,Other
2023-02-16,2023-02-16,5490990789,46760858773,-37.5,180.45,Other
2023-02-16,2023-02-16,5490990789,46736344968,212.08,217.95,Other
2023-02-13,2023-02-12,5490990789,46739127037,-30.0,5.87,Other
2023-02-13,2023-02-12,5490990789,46733251396,30.0,35.87,Other
2023-02-06,2023-02-04,5490990789,46736344968,-110.0,5.87,Other
2023-02-03,2023-02-03,5490990789,46724445660,-35.0,115.87,Other
2023-01-25,2023-01-25,3781981004,LÃN,126.0,150.87,Other
2023-01-04,2023-01-04,5490990789,46736344968,-249.0,24.87,Other
2022-12-27,2022-12-26,5484618728,2535 STARBUC/22-12-24,-51.0,273.87,Other
2022-12-27,2022-12-26,5484618370,WHSMITH DE 2/22-12-24,-158.0,324.87,Other
2022-12-27,2022-12-25,5484571333,ARLANDA T2 T/22-12-24,-118.0,482.87,Other
2022-12-27,2022-12-24,5484763199,NOBLE SWEDIS/22-12-23,-35.0,600.87,Other
2022-12-27,2022-12-24,5490990789,46734788363,-298.0,635.87,Other
2022-12-23,2022-12-23,5484669827,ICA LAPPKARR/22-12-22,-95.9,933.87,Groceries
2022-12-19,2022-12-19,5484209746,PROFESSORN R/22-12-18,-125.0,1029.77,Other
2022-12-19,2022-12-18,5484745024,MAX BURGERS /22-12-17,-138.0,1154.77,Restaurants
2022-12-19,2022-12-17,5490990789,46733251396,-14.0,1292.77,Other
2022-12-19,2022-12-17,5490990789,46733251396,14.0,1306.77,Other
2022-12-19,2022-12-17,5484677653,ICA LAPPKARR/22-12-16,-152.4,1292.77,Groceries
2022-12-19,2022-12-17,5490990789,46769600091,-30.0,1445.17,Other
2022-12-13,2022-12-13,5490990789,46736344968,130.0,1475.17,Other
2022-12-13,2022-12-13,5490990789,1231351014,-113.0,1345.17,Other
2022-12-12,2022-12-10,5490990789,AB STORSTOCK,-26.0,1458.17,Other
2022-12-12,2022-12-10,5490990789,46736344968,64.0,1484.17,Other
2022-12-12,2022-12-10,5490990789,AB STORSTOCK,-26.0,1420.17,Other
2022-12-07,2022-12-07,5490990789,AB STORSTOCK,-26.0,1446.17,Other
2022-12-06,2022-12-06,5490990789,A-TRAIN AKTI,-149.0,1472.17,Other
2022-12-05,2022-12-04,5484480198,AMSTERDAM   /22-12-04,-11.13,1621.17,Other
2022-12-05,2022-12-03,5484636120,AMSTERDAM   /22-12-02,-223.55,1632.3,Other
2022-12-05,2022-12-03,5484062067,AMSTERDAM   /22-12-02,-1114.37,1855.85,Other
2022-12-02,2022-12-02,5484402298,S-GRAVENHAG/22-12-01,-441.51,2970.22,Other
2022-11-30,2022-11-30,5484356297,TICKETLY-SI /22-11-29,-60.0,3411.73,Other
2022-11-30,2022-11-30,5484356296,TICKETLY-SI /22-11-29,-60.0,3471.73,Other
2022-11-28,2022-11-26,5484878013,ICA LAPPKARR/22-11-25,-65.0,3531.73,Groceries
2022-11-28,2022-11-26,5484878012,ICA LAPPKARR/22-11-25,-250.1,3596.73,Groceries
2022-11-28,2022-11-26,5490990789,A-TRAIN AKTI,-149.0,3846.83,Other
2022-11-28,2022-11-26,5490990789,AB STORSTOCK,-26.0,3995.83,Other
2022-11-25,2022-11-25,5490990789,46736344968,250.1,4021.83,Other
2022-11-25,2022-11-25,5490990789,46736344968,3000.0,3771.73,Other
2022-11-24,2022-11-24,5484828338,HIMALAYA LIV/22-11-22,-124.79,771.73,Other
2022-11-24,2022-11-24,5490990789,46733251397,-250.0,896.52,Other
2022-11-17,2022-11-17,5484250381,ICA LAPPKARR/22-11-16,-13.9,1146.52,Groceries
2022-11-14,2022-11-13,5484568044,ICA LAPPKARR/22-11-12,-147.7,1160.42,Groceries
2022-11-14,2022-11-12,5484058177,BASTARD BURG/22-11-11,-175.0,1308.12,Other
2022-11-14,2022-11-12,5484057904,CLAS OHLSON /22-11-11,-49.9,1483.12,Other
2022-11-14,2022-11-12,5484057886,CLAS OHLSON /22-11-11,159.9,1533.02,Other
2022-11-11,2022-11-11,5490990789,46736344968,-160.0,1373.12,Other
2022-11-11,2022-11-11,5490990789,46736344968,-3000.0,1533.12,Other
2022-11-11,2022-11-11,5841990687,H11480819682,4000.0,4533.12,Other
2022-11-07,2022-11-06,5484536301,ICA LAPPKARR/22-11-05,-23.9,533.12,Groceries
2022-11-07,2022-11-06,5484262168,FRESCATI SPO/22-11-05,-30.0,557.02,Other
2022-11-07,2022-11-05,5490990789,46736344968,250.0,587.02,Other
2022-11-04,2022-11-04,5490990789,SJ AB,-90.0,337.02,Transport
2022-11-04,2022-11-04,5484527608,4208856 PRES/22-11-03,-20.0,427.02,Other
2022-11-04,2022-11-04,5490990789,AB STORSTOCK,-99.0,447.02,Other
2022-11-03,2022-11-03,5490990789,46733251397,-400.0,546.02,Other
2022-11-01,2022-11-01,5490990789,46764341590,-119.0,946.02,Other
2022-11-01,2022-11-01,5841990687,H01479998862,1000.0,1065.02,Other
2022-10-31,2022-10-29,5484091147,PROFESSORN R/22-10-28,-35.0,65.02,Other
2022-10-31,2022-10-29,5484621339,ICA LAPPKARR/22-10-28,-13.9,100.02,Groceries
2022-10-31,2022-10-29,5490990789,TEKNISKA HÃG,-365.0,113.92,Other
2022-10-31,2022-10-29,5490990789,46733251397,400.0,478.92,Other
2022-10-17,2022-10-15,5490990789,46733251396,66.0,78.92,Other
2022-10-04,2022-10-04,5490990789,46769600091,-35.0,12.92,Other
2022-10-04,2022-10-04,5490990789,46733251396,30.0,47.92,Other
2022-10-03,2022-10-01,5484673415,HEMKÃP BREDÃ/22-09-30,-30.85,17.92,Other
2022-10-03,2022-10-01,5484529932,ICA LAPPKARR/22-09-30,-20.0,48.77,Groceries
2022-10-03,2022-10-01,5490990789,46764391006,-40.0,68.77,Other
2022-09-30,2022-09-30,5490990789,46736344968,100.0,108.77,Other
2022-09-30,2022-09-30,5490990789,AB STORSTOCK,-26.0,8.77,Other
2022-09-26,2022-09-26,5484579200,BUCURESTI   /22-09-25,-50.31,34.77,Other
2022-09-26,2022-09-24,5484855732,BUCURESTI   /22-09-22,-63.7,85.08,Other
2022-09-26,2022-09-24,5484855731,BUCURESTI   /22-09-22,-79.63,148.78,Other
2022-09-26,2022-09-24,5484684919,BUCURESTI   /22-09-23,-79.69,228.41,Other
2022-09-23,2022-09-23,5490990789,VY BUSS AB,-219.0,308.1,Transport
2022-09-23,2022-09-23,5490990789,46765552983,223.0,527.1,Other
2022-09-21,2022-09-21,5490990789,46736344968,-216.0,304.1,Other
2022-09-16,2022-09-16,5490990789,46761566895,-35.0,520.1,Other
2022-09-15,2022-09-15,5490990789,46727717801,-97.5,555.1,Other
2022-09-14,2022-09-14,5490990789,46761572904,150.0,652.6,Other
2022-09-12,2022-09-10,5490990789,46727765928,35.0,502.6,Other
2022-09-12,2022-09-10,5490990789,46764331918,35.0,467.6,Other
2022-09-12,2022-09-10,5490990789,46727765928,35.0,432.6,Other
2022-09-12,2022-09-10,5490990789,46733251397,300.0,397.6,Other
2022-09-08,2022-09-08,5490990789,POSTNORD SVE,-78.0,97.6,Other
2022-09-06,2022-09-06,5490990789,46734788363,-100.0,175.6,Other
2022-09-05,2022-09-03,5490990789,46734788363,-200.0,275.6,Other
2022-09-05,2022-09-03,5490990789,46764360375,249.0,475.6,Other
2022-09-01,2022-09-01,5490990789,46766327107,75.0,226.6,Other
2022-08-30,2022-08-30,5490990789,46736975740,-62.0,151.6,Other
2022-08-26,2022-08-26,5490990789,46769627063,50.0,213.6,Other
2022-08-22,2022-08-22,5490990789,46734788363,-50.0,163.6,Other
2022-08-22,2022-08-22,5490990789,46734788363,12.0,213.6,Other
2022-08-22,2022-08-20,5490990789,46761572904,30.0,201.6,Other
2022-08-19,2022-08-19,5490990789,46734788363,50.0,171.6,Other
2022-08-19,2022-08-19,5490990789,46769627063,50.0,121.6,Other
2022-08-19,2022-08-19,5490990789,46764550932,30.0,71.6,Other
2022-08-17,2022-08-17,5490990789,46728525608,-110.0,41.6,Other
2022-08-16,2022-08-16,5484238082,ICA LAPPKARR/22-08-15,-36.5,151.6,Groceries
2022-08-16,2022-08-16,5490990789,46764316466,15.0,188.1,Other
2022-08-16,2022-08-16,5490990789,46764316466,-70.0,173.1,Other
2022-08-15,2022-08-15,5484592027,ICA LAPPKARR/22-08-14,-106.28,243.1,Groceries
2022-08-15,2022-08-14,5484729965,4318134 7-EL/22-08-13,-25.0,349.38,Utilities
2022-08-15,2022-08-14,5484435223,BASTARD BURG/22-08-12,-169.0,374.38,Other
2022-08-15,2022-08-13,5484870318,SYSTEMBOLAGE/22-08-12,-46.2,543.38,Other
2022-08-15,2022-08-13,5484445246,OOB SVEAVAGE/22-08-12,-231.0,589.58,Other
2022-08-15,2022-08-13,5484461840,ICA LAPPKARR/22-08-12,-20.0,820.58,Groceries
2022-08-12,2022-08-12,5484459594,ICA LAPPKARR/22-08-11,-33.4,840.58,Groceries
2022-08-12,2022-08-12,5484459461,ICA LAPPKARR/22-08-10,-143.38,873.98,Groceries
2022-08-12,2022-08-12,5484459301,ICA LAPPKARR/22-08-09,-47.9,1017.36,Groceries
2022-08-09,2022-08-09,5484682370,WOLT        /22-08-08,-202.0,1065.26,Other
2022-08-08,2022-08-08,5484498497,HOTEL AT SIX/22-08-06,-147.0,1267.26,Utilities
2022-08-08,2022-08-08,5490990789,46736971950,400.0,1414.26,Other
2022-08-08,2022-08-07,5484029811,MAX BURGERS /22-08-07,-158.0,1014.26,Restaurants
2022-08-08,2022-08-06,5490990789,46736344968,72.0,1172.26,Other
2022-08-08,2022-08-06,5490990789,AB STORSTOCK,-26.0,1100.26,Other
2022-08-02,2022-08-02,5490990789,46736344968,-119.0,1126.26,Other
2022-08-01,2022-08-01,5490990789,46737265219,900.0,1245.26,Other
2022-08-01,2022-08-01,5490990789,46768162322,70.0,345.26,Other
2022-08-01,2022-08-01,5490990789,46735335998,70.0,275.26,Other
2022-08-01,2022-08-01,5490990789,46727294589,70.0,205.26,Other
2022-07-27,2022-07-27,5490990789,AB STORSTOCK,-26.0,135.26,Other
2022-07-25,2022-07-25,5490990789,46769600091,-30.0,161.26,Other
2022-07-22,2022-07-22,5490990789,46764332820,-30.0,191.26,Other
2022-07-21,2022-07-21,5484025281,STARBUCKS AV/22-07-20,-46.0,221.26,Other
2022-07-20,2022-07-20,5490990789,AB STORSTOCK,-26.0,267.26,Other
2022-07-20,2022-07-20,5490990789,46733251396,170.0,293.26,Other
2022-07-19,2022-07-19,5484524550,ICA LAPPKARR/22-07-18,-31.1,123.26,Groceries
2022-07-18,2022-07-17,5484178663,ICA LAPPKARR/22-07-16,-49.0,154.36,Groceries
2022-07-18,2022-07-16,5484595296,ICA LAPPKARR/22-07-15,-61.5,203.36,Groceries
2022-07-13,2022-07-13,5490990789,AB STORSTOCK,-26.0,264.86,Other
2022-07-13,2022-07-13,5490990789,AB STORSTOCK,-26.0,290.86,Other
2022-07-11,2022-07-11,5490990789,46733251397,55.0,316.86,Other
2022-07-07,2022-07-07,5490990789,46727721528,33.5,261.86,Other
2022-07-07,2022-07-07,5490990789,46727717801,-62.0,228.36,Other
2022-07-06,2022-07-06,5484495583,NGROCERIES  /22-07-05,-610.84,290.36,Other
2022-07-05,2022-07-05,5490990789,46734788363,11.0,901.2,Other
2022-07-05,2022-07-05,5484402695,LIDL 335/OST/22-07-04,-575.35,890.2,Groceries
2022-07-05,2022-07-05,5484491613,ICA LAPPKARR/22-07-04,-45.4,1465.55,Groceries
2022-07-05,2022-07-05,5490990789,46734788363,600.0,1510.95,Other
2022-07-04,2022-07-04,5484566568,TACO BAR I S/22-07-01,-192.0,910.95,Other
2022-07-04,2022-07-04,5484559579,MCDONALDS 21/22-07-01,-59.0,1102.95,Restaurants
2022-07-04,2022-07-04,5484437904,TEMPO SANDVI/22-07-03,-53.9,1161.95,Other
2022-07-04,2022-07-04,5484745861,KLOVER ESS T/22-07-02,-25.0,1215.85,Other
2022-07-04,2022-07-04,5490990789,46733251396,156.0,1240.85,Other
2022-07-04,2022-07-04,5490990789,SJ AB,-502.0,1084.85,Transport
2022-07-04,2022-07-03,5484677353,TEMPO SANDVI/22-07-02,-51.95,1586.85,Other
2022-07-04,2022-07-03,5484879937,INDIAN PALAC/22-07-02,-149.0,1638.8,Other
2022-07-04,2022-07-02,5484344891,4250150 PRES/22-07-01,-19.0,1787.8,Other
2022-07-04,2022-07-02,5484323357,THE LOCAL BA/22-07-01,-430.0,1806.8,Other
2022-07-04,2022-07-02,5490990789,REGION GÃVLE,-24.0,2236.8,Other
2022-07-04,2022-07-02,5490990789,REGION GÃVLE,-24.0,2260.8,Other
2022-07-01,2022-07-01,5484364120,ICA LAPPKARR/22-06-30,-59.0,2284.8,Groceries
2022-07-01,2022-07-01,5490990789,46733251396,96.0,2343.8,Other
2022-06-30,2022-06-30,5490990789,SJ AB,-157.0,2247.8,Transport
2022-06-29,2022-06-29,5484769514,CARLINGS 588/22-06-28,-399.0,2404.8,Other
2022-06-27,2022-06-27,5484641733,4208856 PRES/22-06-26,-76.0,2803.8,Other
2022-06-27,2022-06-27,5484355688,INDIAN STREE/22-06-26,-175.0,2879.8,Other
2022-06-27,2022-06-27,8901948716,INLÃST AVI,945.0,3054.8,Other
2022-06-27,2022-06-26,5484373113,ICA NARA ALV/22-06-25,-247.5,2109.8,Groceries
2022-06-27,2022-06-26,5490990789,46720159309,-128.0,2357.3,Other
2022-06-27,2022-06-24,5484358311,SYSTEMBOLAGE/22-06-23,-505.9,2485.3,Other
2022-06-27,2022-06-24,5484172633,MORMOS DUMPL/22-06-23,-115.0,2991.2,Other
2022-06-27,2022-06-24,5484719805,OOB SVEAVAGE/22-06-23,-105.0,3106.2,Other
2022-06-27,2022-06-24,5484725303,ICA LAPPKARR/22-06-23,-273.29,3211.2,Groceries
2022-06-27,2022-06-24,5484654036,CLAS OHLSON /22-06-23,-159.9,3484.49,Other
2022-06-23,2022-06-23,5490990789,46736344968,189.0,3644.39,Other
2022-06-23,2022-06-23,5490990789,46731615742,43.0,3455.39,Other
2022-06-23,2022-06-23,5490990789,46736344968,43.33,3412.39,Other
2022-06-23,2022-06-23,5490990789,46731615742,228.0,3369.06,Other
2022-06-23,2022-06-23,3781981004,LÃN,3000.0,3141.06,Other
2022-06-20,2022-06-18,5490990789,46736344968,-40.9,141.06,Other
2022-06-17,2022-06-17,5490990789,46761575633,-55.0,181.96,Other
2022-06-10,2022-06-10,5484355647,ICA LAPPKARR/22-06-09,-11.3,236.96,Groceries
2022-06-09,2022-06-09,5484011838,SOLSKEN TOBA/22-06-08,-25.0,248.26,Other
2022-06-09,2022-06-09,5484472460,ICA SUPERMAR/22-06-08,-140.49,273.26,Groceries
2022-06-09,2022-06-09,5484447550,ICA LAPPKARR/22-06-08,-57.0,413.75,Groceries
2022-06-09,2022-06-09,5484447540,ICA LAPPKARR/22-06-08,-56.9,470.75,Groceries
2022-06-09,2022-06-09,5490990789,46731615742,16.0,527.65,Other
2022-06-09,2022-06-09,5490990789,1235064050,-28.0,511.65,Other
2022-06-07,2022-06-07,5490990789,46736344968,-100.0,539.65,Other
2022-06-07,2022-06-07,5490990789,AKTIEBOLAGET,-30.0,639.65,Other
2022-06-07,2022-06-06,5490990789,46731615742,290.0,669.65,Other
2022-06-07,2022-06-06,5490990789,46736344968,345.0,379.65,Other
2022-06-07,2022-06-04,5484805878,4618147 7-EL/22-06-03,-37.82,34.65,Utilities
2022-06-07,2022-06-04,5490990789,AB STORSTOCK,-26.0,72.47,Other
2022-06-07,2022-06-04,5490990789,46769704034,-50.0,98.47,Other
2022-06-03,2022-06-03,5490990789,46764332820,-30.0,148.47,Other
2022-06-01,2022-06-01,5490990789,AB STORSTOCK,-26.0,178.47,Other
2022-05-30,2022-05-30,5484830800,BURGER KING /22-05-28,-75.0,204.47,Restaurants
2022-05-30,2022-05-29,5484707960,MAX STHLM 28/22-05-27,-158.0,279.47,Restaurants
2022-05-30,2022-05-29,5490990789,46736344968,-37.5,437.47,Other
2022-05-27,2022-05-27,5490990789,46793255306,180.0,474.97,Other
2022-05-27,2022-05-27,5484280831,STARBUCKS AV/22-05-26,-89.0,294.97,Other
2022-05-27,2022-05-27,5484235307,SECOND HAND /22-05-26,-80.0,383.97,Other
2022-05-27,2022-05-26,5490990789,46731615742,67.0,463.97,Other
2022-05-23,2022-05-22,5490990789,46736344968,-70.0,396.97,Other
2022-05-23,2022-05-22,5490990789,1236494066,-10.0,466.97,Other
2022-05-23,2022-05-22,5490990789,1236231492,-60.0,476.97,Other
2022-05-20,2022-05-20,5490990789,46736344968,192.0,536.97,Other
2022-05-13,2022-05-13,5490990789,46760084856,60.0,344.97,Other
2022-05-13,2022-05-13,5490990789,46760858773,120.0,284.97,Other
2022-05-12,2022-05-12,5490990789,46731615742,75.0,164.97,Other
2022-05-12,2022-05-12,5490990789,46731615742,-40.0,89.97,Other
2022-05-05,2022-05-05,5490990789,46736344968,-25.0,129.97,Other
2022-05-02,2022-05-02,5490990789,46793255306,-110.6,154.97,Other
2022-05-02,2022-05-01,5490990789,AB STORSTOCK,-26.0,265.57,Other
2022-05-02,2022-05-01,5490990789,AB STORSTOCK,-26.0,291.57,Other
2022-05-02,2022-05-01,5490990789,46731615742,-130.0,317.57,Other
2022-05-02,2022-04-30,5490990789,AB STORSTOCK,-99.0,447.57,Other
2022-04-26,2022-04-26,5490990789,46739921466,-100.0,546.57,Other
2022-04-25,2022-04-25,5490990789,46733251397,500.0,646.57,Other
2022-04-19,2022-04-15,5490990789,46767403059,-500.0,146.57,Other
2022-04-13,2022-04-13,5490990789,46731615742,250.0,646.57,Other
2022-04-13,2022-04-13,5490990789,46736344968,-500.0,396.57,Other
2022-04-13,2022-04-13,5490990789,46736344968,500.0,896.57,Other
2022-04-11,2022-04-11,5490990789,46767418438,-80.0,396.57,Other
2022-04-11,2022-04-10,5490990789,46736344968,-500.0,476.57,Other
2022-04-11,2022-04-10,5490990789,46736344968,500.0,976.57,Other
2022-04-05,2022-04-05,5484345581,ICA LAPPKARR/22-04-04,-89.0,476.57,Groceries
2022-04-04,2022-04-04,5484191121,UBER    EATS/22-04-03,-228.0,565.57,Transport
2022-04-04,2022-04-04,5484632192,ICA LAPPKARR/22-04-02,-135.2,793.57,Groceries
2022-04-04,2022-04-03,5484242248,KITCHENLAB  /22-04-02,-370.0,928.77,Other
2022-04-04,2022-04-03,5484702521,ICA SUPERMAR/22-04-02,-167.84,1298.77,Groceries
2022-04-04,2022-04-02,5490990789,46733251396,185.0,1466.61,Other
2022-03-31,2022-03-31,5490990789,46731615742,-123.4,1281.61,Other
2022-03-31,2022-03-31,5490990789,46736344968,-654.0,1405.01,Other
2022-03-30,2022-03-30,5841990687,H30464395101,2000.0,2059.01,Other
2022-03-24,2022-03-24,5490990789,46764414367,30.0,59.01,Other
2022-03-22,2022-03-22,5490990789,46793402669,-6.0,29.01,Other
2022-03-22,2022-03-22,5490990789,46793402669,6.0,35.01,Other
2022-03-21,2022-03-19,5490990789,46733251397,-250.0,29.01,Other
2022-03-14,2022-03-13,5490990789,46733251396,74.0,279.01,Other
2022-03-09,2022-03-09,5490990789,46731615742,45.0,205.01,Other
2022-03-07,2022-03-06,5490990789,1236494066,-90.0,160.01,Other
2022-02-28,2022-02-26,5490990789,46731615742,163.0,250.01,Other
2022-02-28,2022-02-26,5490990789,46736344968,56.0,87.01,Other
2022-02-21,2022-02-20,5490990789,46731615742,30.0,31.01,Other
2022-02-21,2022-02-20,5484670758,POWER SOURCE/22-02-19,-109.0,1.01,Other
2022-02-21,2022-02-19,5484505088,PIZZA HUT 20/22-02-18,-238.0,110.01,Other
2022-02-21,2022-02-19,5484856411,SYSTEMBOLAGE/22-02-18,-196.3,348.01,Other
2022-02-21,2022-02-19,5484588386,7-ELEVEN    /22-02-18,-28.02,544.31,Other
2022-02-21,2022-02-19,5490990789,46736344968,-2.0,572.33,Other
2022-02-21,2022-02-19,5490990789,46736344968,2.0,574.33,Other
2022-02-16,2022-02-16,5490990789,34677831224,500.0,572.33,Other
2022-02-14,2022-02-14,5490990789,46767533861,-44.0,72.33,Other
2022-02-14,2022-02-12,5490990789,46736344968,-58.0,116.33,Other
2022-02-09,2022-02-09,5490990789,34677831224,-500.0,174.33,Other
2022-02-07,2022-02-07,5484731429,7-ELEVEN    /22-02-06,-33.02,674.33,Other
2022-02-07,2022-02-07,5484218299,LILLEBRORS B/22-02-06,-35.0,707.35,Other
2022-02-07,2022-02-05,5484291941,POWER SOURCE/22-02-04,-109.0,742.35,Other
2022-02-07,2022-02-05,5490990789,1230919100,-109.0,851.35,Other
2022-02-03,2022-02-03,5484869102,HIMALAYA LIV/22-02-01,-87.63,960.35,Other
2022-02-02,2022-02-02,5484115473,127 - UNIVER/22-01-31,-650.0,1047.98,Other
2022-02-02,2022-02-02,5484602831,KTH STORIES /22-02-01,-54.0,1697.98,Other
2022-02-01,2022-02-01,5484590053,ICA LAPPKARR/22-01-31,-78.3,1751.98,Groceries
2022-02-01,2022-02-01,5484589982,ICA LAPPKARR/22-01-31,-69.34,1830.28,Groceries
2022-01-31,2022-01-31,9900003100,FITNESS24,-115.0,1899.62,Other
2022-01-31,2022-01-30,5490990789,46761879407,50.0,2014.62,Other
2022-01-31,2022-01-30,5484792082,ICA LAPPKARR/22-01-29,-49.5,1964.62,Groceries
2022-01-31,2022-01-29,5490990789,46704109524,-450.0,2014.12,Other
2022-01-27,2022-01-27,5490990789,46731615742,18.0,2464.12,Other
2022-01-27,2022-01-27,5490990789,SERGEL KREDI,-533.15,2446.12,Utilities
2022-01-25,2022-01-25,3781981004,LÃN,126.0,2979.27,Other
2022-01-24,2022-01-24,5490990789,46769771146,-10.0,2853.27,Other
2022-01-24,2022-01-24,5490990789,46769771146,10.0,2863.27,Other
2022-01-20,2022-01-20,5490990789,46734951209,35.0,2853.27,Other
2022-01-17,2022-01-15,5490990789,46736344968,20.0,2818.27,Other
2022-01-13,2022-01-13,5490990789,46767440716,35.0,2798.27,Other
2022-01-13,2022-01-13,5490990789,46793255306,30.0,2763.27,Other
2022-01-03,2021-12-31,5490990789,AB STORSTOCK,-25.0,2733.27,Other
2021-12-30,2021-12-31,5490990010,RÃNTA,-0.03,2758.27,Other
2021-12-30,2021-12-30,5490990789,AB STORSTOCK,-25.0,2758.3,Other
2021-12-30,2021-12-30,5490990789,AB STORSTOCK,-25.0,2783.3,Other
2021-12-29,2021-12-29,9900003100,FITNESS24,-229.0,2808.3,Other
2021-12-15,2021-12-15,5490990789,46733251397,-165.0,3037.3,Other
2021-12-13,2021-12-11,5490990789,AB STORSTOCK,-25.0,3202.3,Other
2021-12-13,2021-12-10,5490990789,AB STORSTOCK,-25.0,3227.3,Other
2021-12-06,2021-12-05,5490990789,AB STORSTOCK,-25.0,3252.3,Other
2021-11-29,2021-11-29,9900003100,FITNESS24,-229.0,3277.3,Other
2021-11-29,2021-11-28,5490990789,46736344968,150.0,3506.3,Other
2021-11-29,2021-11-27,5490990789,46731615742,150.0,3356.3,Other
2021-11-26,2021-11-26,5490990789,46733251397,1600.0,3206.3,Other
2021-11-25,2021-11-25,5490990789,INTRUM SVERI,-4878.61,1606.3,Other
2021-11-25,2021-11-25,5841990687,H25455980798,5000.0,6484.91,Other
2021-11-22,2021-11-20,5490990789,46765552983,-120.0,1484.91,Other
2021-11-22,2021-11-20,5490990789,46736344968,60.0,1604.91,Other
2021-11-16,2021-11-16,5490990789,46734788363,217.0,1544.91,Other
2021-11-15,2021-11-15,5490990789,46731615742,-50.0,1327.91,Other
2021-11-15,2021-11-15,5490990789,46736344968,-50.0,1377.91,Other
2021-11-15,2021-11-15,5490990789,46731615742,50.0,1427.91,Other
2021-11-15,2021-11-15,5490990789,46736344968,50.0,1377.91,Other
2021-11-15,2021-11-15,5490990789,AB STORSTOCK,-25.0,1327.91,Other
2021-11-15,2021-11-14,5490990789,AB STORSTOCK,-25.0,1352.91,Other
2021-11-15,2021-11-14,5490990789,AB STORSTOCK,-25.0,1377.91,Other
2021-11-15,2021-11-13,5490990789,AB STORSTOCK,-25.0,1402.91,Other
2021-11-12,2021-11-12,5490990789,AB STORSTOCK,-25.0,1427.91,Other
2021-11-08,2021-11-06,5490990789,46708391674,-90.0,1452.91,Other
2021-11-01,2021-11-01,5490990789,46727721528,-392.0,1542.91,Other
2021-11-01,2021-10-31,5490990789,46733251397,-5800.0,1934.91,Other
2021-10-29,2021-10-29,5490990789,46733251397,-1000.0,7734.91,Other
2021-10-29,2021-10-29,9900003100,FITNESS24,-229.0,8734.91,Other
2021-10-28,2021-10-28,5490990789,46733251397,2800.0,8963.91,Other
2021-10-28,2021-10-28,5490990789,46733251397,4000.0,6163.91,Other
2021-10-27,2021-10-27,5841990687,H27453984930,2000.0,2163.91,Other
2021-10-26,2021-10-26,5490990789,46769771146,75.0,163.91,Other
2021-10-19,2021-10-19,5490990789,46707153608,70.0,88.91,Other
2021-10-04,2021-10-02,5490990789,46736344968,55.0,18.91,Other
2021-09-30,2021-09-30,5490990010,RÃNTA,-0.18,-36.09,Other
2021-09-29,2021-09-29,9900003100,FITNESS24,-229.0,-35.91,Other
2021-09-22,2021-09-22,5490990789,46730946530,-250.0,193.09,Other
2021-09-20,2021-09-20,5490990789,46764422936,-81.0,443.09,Other
2021-09-20,2021-09-19,5490990789,46736344968,135.0,524.09,Other
2021-09-20,2021-09-19,5490990789,46731615742,135.0,389.09,Other
2021-09-20,2021-09-19,5490990789,46734794596,-75.0,254.09,Other
2021-09-13,2021-09-13,5490990789,46728442238,-108.0,329.09,Other
2021-09-13,2021-09-12,5490990789,AB STORSTOCK,-25.0,437.09,Other
2021-09-13,2021-09-12,5490990789,AB STORSTOCK,-25.0,462.09,Other
2021-09-13,2021-09-11,5490990789,46707411412,-168.0,487.09,Other
2021-09-06,2021-09-05,5490990789,46731615742,25.0,655.09,Other
2021-09-06,2021-09-04,5490990789,AB STORSTOCK,-25.0,630.09,Other
2021-09-06,2021-09-04,5490990789,46731615742,29.0,655.09,Other
2021-09-06,2021-09-04,5490990789,AB STORSTOCK,-25.0,626.09,Other
2021-08-31,2021-08-31,5490990789,46734887840,-57.5,651.09,Other
2021-08-31,2021-08-31,5490990789,46767403059,-35.0,708.59,Other
2021-08-31,2021-08-31,5490990789,46793402669,-84.84,743.59,Other
2021-08-31,2021-08-31,5490990789,46767456961,250.0,828.43,Other
2021-08-31,2021-08-31,5490990789,46733251396,-40.0,578.43,Other
2021-08-31,2021-08-31,5490990789,46733251396,40.0,618.43,Other
2021-08-30,2021-08-30,9900003100,FITNESS24,-229.0,578.43,Other
2021-08-25,2021-08-25,5490990789,46731615742,108.0,807.43,Other
2021-08-25,2021-08-25,5490990789,46736344968,83.0,699.43,Other
2021-08-25,2021-08-25,5484783758,LIDL 257 / S/21-08-24,-71.08,616.43,Groceries
2021-08-25,2021-08-25,5484208787,FALAFELKUNGE/21-08-24,-89.0,687.51,Other
2021-08-25,2021-08-25,5490990789,46760858773,-13.3,776.51,Other
2021-08-25,2021-08-25,5490990789,AB STORSTOCK,-25.0,789.81,Other
2021-08-24,2021-08-24,5490990789,AB STORSTOCK,-25.0,814.81,Other
2021-08-23,2021-08-23,5841990687,H23449610394,500.0,839.81,Other
2021-08-23,2021-08-22,5490990789,46760858773,215.6,339.81,Other
2021-08-23,2021-08-21,5490990789,AB STORSTOCK,-25.0,124.21,Other
2021-08-23,2021-08-21,5490990789,AB STORSTOCK,-25.0,149.21,Other
2021-08-16,2021-08-15,5490990789,46734769962,60.0,174.21,Other
2021-08-16,2021-08-15,5490990789,46734948210,49.5,114.21,Other
2021-08-11,2021-08-11,5490990789,46727721528,-230.0,64.71,Other
2021-08-06,2021-08-06,5490990789,46736344968,25.0,294.71,Other
2021-08-06,2021-08-06,5490990789,46704029196,-128.0,269.71,Other
2021-08-06,2021-08-06,5490990789,46731615742,62.0,397.71,Other
2021-08-04,2021-08-04,5490990789,46736344968,-129.0,335.71,Other
2021-08-02,2021-08-01,5490990789,46707411160,-250.0,464.71,Other
2021-08-02,2021-08-01,5490990789,46728440144,-30.0,714.71,Other
2021-08-02,2021-07-31,5490990789,46727771950,120.0,744.71,Other
2021-08-02,2021-07-31,5490990789,46734887840,120.0,624.71,Other
2021-08-02,2021-07-31,5490990789,46731615742,-120.0,504.71,Other
2021-08-02,2021-07-31,5490990789,46731615742,120.0,624.71,Other
2021-08-02,2021-07-31,5490990789,46731615742,120.0,504.71,Other
2021-08-02,2021-07-31,5490990789,46727717801,120.0,384.71,Other
2021-08-02,2021-07-31,5490990789,46733251396,120.0,264.71,Other
2021-07-29,2021-07-29,9900003100,FITNESS24,-229.0,144.71,Other
2021-07-29,2021-07-29,1209900000,COLLECTIA INKASSO,-449.0,373.71,Other
2021-07-28,2021-07-28,5841990687,H28448050912,500.0,822.71,Other
2021-07-27,2021-07-27,5490990789,46734788363,219.0,322.71,Other
2021-07-27,2021-07-27,5490990789,46727717801,3.3,103.71,Other
2021-07-26,2021-07-24,5490990789,46764427435,-30.0,100.41,Other
2021-07-26,2021-07-24,5490990789,46736249473,-30.0,130.41,Other
2021-07-22,2021-07-22,5490990789,46733251396,86.0,160.41,Other
2021-07-16,2021-07-16,5490990789,46760858773,100.0,74.41,Other
2021-06-30,2021-06-30,5490990789,46733251396,40.0,-25.59,Other
2021-06-29,2021-06-29,9900003100,FITNESS24,-229.0,-65.59,Other
2021-06-28,2021-06-28,5490990789,46793376434,-30.0,163.41,Other
2021-06-28,2021-06-28,5490990789,46733251397,170.0,193.41,Other
2021-06-28,2021-06-27,5490990789,46761575633,5.0,23.41,Other
2021-06-28,2021-06-27,5490990789,46793376434,-30.0,18.41,Other
2021-06-28,2021-06-27,5490990789,46724038471,-35.0,48.41,Other
2021-06-28,2021-06-27,5490990789,46728440144,-30.0,83.41,Other
2021-06-28,2021-06-26,5490990789,AB STORSTOCK,-25.0,113.41,Other
2021-06-28,2021-06-26,5490990789,AB STORSTOCK,-25.0,138.41,Other
2021-06-24,2021-06-24,5490990789,AB STORSTOCK,-25.0,163.41,Other
2021-06-24,2021-06-24,5490990789,AB STORSTOCK,-25.0,188.41,Other
2021-06-24,2021-06-24,5490990789,AB STORSTOCK,-25.0,213.41,Other
2021-06-24,2021-06-24,5490990789,46733251397,-25.0,238.41,Other
2021-06-22,2021-06-22,5490990789,AB STORSTOCK,-25.0,263.41,Other
2021-06-21,2021-06-21,5490990789,46733251397,-194.0,288.41,Other
2021-06-21,2021-06-21,5490990789,AB STORSTOCK,-25.0,482.41,Other
2021-06-21,2021-06-21,5490990789,46733251397,-180.0,507.41,Other
2021-06-21,2021-06-20,5490990789,AB STORSTOCK,-25.0,687.41,Other
2021-06-21,2021-06-20,5490990789,AB STORSTOCK,-25.0,712.41,Other
2021-06-21,2021-06-19,5490990789,REITAN CONVE,-75.0,737.41,Other
2021-06-21,2021-06-19,5490990789,AB STORSTOCK,-25.0,812.41,Other
2021-06-21,2021-06-19,5490990789,46733251397,-75.0,837.41,Other
2021-06-18,2021-06-18,5490990789,46733251397,200.0,912.41,Other
2021-06-18,2021-06-18,5490990789,46733251397,-200.0,712.41,Other
2021-06-18,2021-06-18,5490990789,393455705651,-690.0,912.41,Other
2021-06-17,2021-06-17,5490990789,AB STORSTOCK,-25.0,1602.41,Other
2021-06-17,2021-06-17,5490990789,AB STORSTOCK,-25.0,1627.41,Other
2021-06-15,2021-06-15,5484358361,ETR SUPERSAV/21-06-14,-1552.0,1652.41,Other
2021-06-14,2021-06-14,5490990789,46733251397,50.0,3204.41,Other
2021-06-14,2021-06-13,5490990789,46731615742,100.0,3154.41,Other
2021-06-11,2021-06-11,3781981004,LÃN,3000.0,3054.41,Other
2021-06-08,2021-06-08,5490990789,46767403059,-250.0,54.41,Other
2021-06-08,2021-06-08,5490990527,HARSHDEEPSIN,293.9,304.41,Other
2021-06-08,2021-06-08,5490990789,46767403059,-250.0,10.51,Other
2021-06-08,2021-06-08,5490990789,46733251397,260.0,260.51,Other
2021-06-04,2021-06-04,5490990789,46708200357,-200.0,0.51,Other
2021-05-31,2021-05-31,9900003100,FITNESS24,-229.0,200.51,Other
2021-05-31,2021-05-29,5490990789,ORDR SWEDEN,-145.0,429.51,Other
2021-05-26,2021-05-26,5490990789,46734769962,200.0,574.51,Other
2021-05-25,2021-05-25,5490990789,46736344968,200.0,374.51,Other
2021-05-25,2021-05-25,5490990789,46733251397,30.0,174.51,Other
2021-05-24,2021-05-24,5490990789,46733251397,-795.0,144.51,Other
2021-05-24,2021-05-24,5841990687,H24443742282,795.0,939.51,Other
2021-05-17,2021-05-17,5490990789,46764552794,20.0,144.51,Other
2021-05-17,2021-05-16,5490990789,46731612201,-14.79,124.51,Other
2021-05-14,2021-05-14,5490990789,AB STORSTOCK,-25.0,139.3,Other
2021-05-14,2021-05-13,5490990789,AB STORSTOCK,-25.0,164.3,Other
2021-05-14,2021-05-13,5490990789,46725939835,-120.0,189.3,Other
2021-05-14,2021-05-13,5490990789,AB STORSTOCK,-25.0,309.3,Other
2021-05-12,2021-05-12,5490990789,AB STORSTOCK,-25.0,334.3,Other
2021-05-11,2021-05-11,5490990789,AB STORSTOCK,-25.0,359.3,Other
2021-05-11,2021-05-11,5490990789,AB STORSTOCK,-25.0,384.3,Other
2021-05-10,2021-05-10,5490990789,AB STORSTOCK,-25.0,409.3,Other
2021-05-07,2021-05-07,5490990789,46722780318,-68.0,434.3,Other
2021-04-29,2021-04-29,5490990789,46733251396,49.0,502.3,Other
2021-04-29,2021-04-29,9900003100,FITNESS24,-229.0,453.3,Other
2021-04-26,2021-04-25,5490990789,46727720962,-106.0,682.3,Other
2021-04-26,2021-04-25,5490990789,46727720962,106.0,788.3,Other
2021-04-20,2021-04-20,5490990789,46734769962,-20.0,682.3,Other
2021-04-19,2021-04-17,5490990789,46727720962,106.0,702.3,Other
2021-04-13,2021-04-13,5490990789,46730957391,-332.17,596.3,Other
2021-04-13,2021-04-13,5490990789,46727717801,-264.88,928.47,Other
2021-04-13,2021-04-13,5490990789,46727721528,8.22,1193.35,Other
2021-04-12,2021-04-11,5490990789,46727721528,-595.96,1185.13,Other
2021-04-08,2021-04-08,5490990789,AB STORSTOCK,-25.0,1781.09,Other
2021-04-06,2021-04-06,5490990789,46736344968,140.0,1806.09,Other
2021-04-06,2021-04-06,5490990789,AB STORSTOCK,-25.0,1666.09,Other
2021-04-06,2021-04-06,5490990789,46760858773,135.0,1691.09,Other
2021-04-06,2021-04-06,5490990789,46736344968,135.0,1556.09,Other
2021-04-06,2021-04-06,5490990789,46736344968,40.0,1421.09,Other
2021-04-06,2021-04-06,5490990789,AB STORSTOCK,-25.0,1381.09,Other
2021-04-06,2021-04-06,5490990789,46767456961,-413.5,1406.09,Other
2021-04-06,2021-04-06,5490990789,46734788363,-12.5,1819.59,Other
2021-04-06,2021-04-06,5490990789,46727771950,-19.96,1832.09,Other
2021-04-06,2021-04-06,5490990789,46734788363,-177.5,1852.05,Other
2021-04-06,2021-04-06,5490990789,46727717801,-74.0,2029.55,Other
2021-04-06,2021-04-06,5490990789,46734769962,-169.0,2103.55,Other
2021-04-06,2021-04-06,5490990789,46760858773,136.0,2272.55,Other
2021-04-06,2021-04-06,5490990004,HARSHDEEPSIN,2000.0,2136.55,Other
2021-04-06,2021-04-06,5490990789,46736344968,136.0,136.55,Other
2021-04-06,2021-04-02,5490990789,46767456961,-99.0,0.55,Other
2021-04-01,2021-04-01,5490990789,46760858773,60.0,99.55,Other
2021-03-29,2021-03-29,9900003100,FITNESS24,-199.0,39.55,Other
2021-03-26,2021-03-26,5490990789,46738399399,6.0,238.55,Other
2021-03-25,2021-03-25,5490990789,46736344968,100.0,232.55,Other
2021-03-25,2021-03-25,5490990789,46736344968,-100.0,132.55,Other
2021-03-25,2021-03-25,5490990789,46736344968,100.0,232.55,Other
2021-03-15,2021-03-15,5490990789,46728442238,-28.0,132.55,Other
2021-03-15,2021-03-13,5490990789,46760858773,60.0,160.55,Other
2021-03-08,2021-03-06,5490990789,AB STORSTOCK,-25.0,100.55,Other
2021-03-08,2021-03-06,5490990789,AB STORSTOCK,-25.0,125.55,Other
2021-03-01,2021-03-01,9900003100,FITNESS24,-199.0,150.55,Other
2021-03-01,2021-02-28,5490990789,46722912612,-80.0,349.55,Other
2021-03-01,2021-02-28,5490990789,1233510781,-20.0,429.55,Other
2021-03-01,2021-02-27,5490990789,AKTIEBOLAGET,-30.0,449.55,Other
2021-02-25,2021-02-25,5490990789,46734769962,94.0,479.55,Other
2021-02-25,2021-02-25,5490990789,46734769962,77.0,385.55,Other
2021-02-22,2021-02-22,5490990789,46733251397,38.0,308.55,Other
2021-02-22,2021-02-21,5490990789,46760858773,59.9,270.55,Other
2021-02-19,2021-02-19,5490990789,46734769962,-114.0,210.65,Other
2021-02-15,2021-02-13,5490990789,46731615742,276.0,324.65,Other
2021-02-15,2021-02-13,5490990789,46734769962,30.0,48.65,Other
2021-02-04,2021-02-04,5490990789,AB STORSTOCK,-25.0,18.65,Other
2021-02-01,2021-01-31,5490990789,AB STORSTOCK,-25.0,43.65,Other
2021-02-01,2021-01-31,5490990789,AB STORSTOCK,-25.0,68.65,Other
2021-02-01,2021-01-30,5490990789,46731615742,38.0,93.65,Other
2021-02-01,2021-01-30,5490990789,46734769962,38.0,55.65,Other
2021-02-01,2021-01-30,5490990789,46736344968,-170.0,17.65,Other
2021-02-01,2021-01-30,5490990789,46734769962,-130.0,187.65,Other
2021-02-01,2021-01-30,5490990789,46736344968,170.0,317.65,Other
2021-02-01,2021-01-30,5490990789,46734769962,130.0,147.65,Other
2021-01-29,2021-01-29,5490990789,1232634566,-420.0,17.65,Other
2021-01-29,2021-01-29,9900003100,FITNESS24,-199.0,437.65,Other
2021-01-28,2021-01-28,5490990789,AB STORSTOCK,-25.0,636.65,Other
2021-01-28,2021-01-28,5490990789,AB STORSTOCK,-25.0,661.65,Other
2021-01-25,2021-01-25,5490990789,46727721528,-98.0,686.65,Other
2021-01-25,2021-01-24,5490990789,AB STORSTOCK,-25.0,784.65,Other
2021-01-25,2021-01-24,5490990789,AB STORSTOCK,-25.0,809.65,Other
2021-01-25,2021-01-24,5490990789,AB STORSTOCK,-25.0,834.65,Other
2021-01-25,2021-01-23,5490990789,AB STORSTOCK,-25.0,859.65,Other
2021-01-25,2021-01-23,5490990789,AB STORSTOCK,-25.0,884.65,Other
2021-01-21,2021-01-21,5490990789,AB STORSTOCK,-25.0,909.65,Other
2021-01-21,2021-01-21,5490990789,46734769962,-20.0,934.65,Other
2021-01-21,2021-01-21,5490990789,AB STORSTOCK,-25.0,954.65,Other
2021-01-18,2021-01-17,5490990789,46734769962,266.0,979.65,Other
2021-01-18,2021-01-16,5490990789,46731615742,226.0,713.65,Other
2021-01-11,2021-01-09,5490990789,46736344968,130.0,487.65,Other
2021-01-11,2021-01-09,5490990789,46734769962,168.0,357.65,Other
2021-01-11,2021-01-09,5490990789,46793402669,-21.0,189.65,Other
2021-01-11,2021-01-09,5490990789,46731615742,130.0,210.65,Other
2021-01-11,2021-01-09,5490990789,46731615742,38.0,80.65,Other
2021-01-11,2021-01-09,5490990789,46736344968,38.0,42.65,Other
2021-01-04,2021-01-04,5490990789,AKTIEBOLAGET,-30.0,4.65,Other
2021-01-04,2021-01-04,5490990789,AB STORSTOCK,-25.0,34.65,Other
2021-01-04,2021-01-03,5490990789,46733251396,25.0,59.65,Other
2020-12-30,2020-12-31,5490990010,RÃNTA,-0.35,34.65,Other
2020-12-28,2020-12-28,5490990789,AB STORSTOCK,-25.0,35.0,Other
2020-12-14,2020-12-13,5490990789,46734769962,130.0,60.0,Other
2020-11-30,2020-11-30,9900003100,FITNESS24,-199.0,-70.0,Other
2020-11-26,2020-11-26,5490990789,46731615742,78.0,129.0,Other
2020-11-26,2020-11-26,5490990789,1232634566,-390.0,51.0,Other
2020-11-25,2020-11-25,5490990789,46727721528,-23.0,441.0,Other
2020-11-17,2020-11-17,5490990789,46734769962,-144.0,464.0,Other
2020-11-16,2020-11-15,5490990789,46736344968,-13.0,608.0,Other
2020-11-13,2020-11-13,5490990789,46731615742,-26.0,621.0,Other
2020-11-12,2020-11-12,5490990789,46734769962,-10.0,647.0,Other
2020-11-09,2020-11-09,5490990789,46767403059,219.0,657.0,Other
2020-11-09,2020-11-07,5490990789,46731615742,160.0,438.0,Other
2020-11-09,2020-11-07,5490990789,46736344968,-25.0,278.0,Other
2020-11-04,2020-11-04,5490990789,46734769962,50.0,303.0,Other
2020-10-28,2020-10-28,5490990789,AKTIEBOLAGET,-40.0,253.0,Other
2020-10-23,2020-10-23,5490990789,46793402669,-30.0,293.0,Other
2020-10-23,2020-10-23,5490990789,46734769962,322.0,323.0,Other
2020-10-20,2020-10-20,5490990789,46734769962,-34.0,1.0,Other
2020-10-20,2020-10-20,5490990789,46736344968,-65.0,35.0,Other
2020-10-20,2020-10-20,5841990687,H20429946794,100.0,100.0,Other
